Orhroud Guelb el Gara est une ville Algérienne. Le code région est 38, les coordonnées géographique de Orhroud Guelb el Gara sont : Latitude 29.59318 et Longitude -1.33068.

Carte Oasis du Hamma - Oasis du Hamma

Carte Ogbat es Sini - Ogbat es Sini

Carte Oggaz - Oggaz L'Oggaz, L'Ougasse, L’Oggaz, L’Ougasse, Marchal Leclerc, Marechal Leclerc, Maréchal Leclerc, Oggaz

Carte Oglat Abderrhamane - Oglat Abderrhamane

Carte Oglat Ahmed - Oglat Ahmed Oglat Ahmed, `Uqlat Ahmad, ‘Uqlat A?mad

Carte Oglat Akerma - Oglat Akerma

Carte Oglat Argaat - Oglat Argaat

Carte Oglat Askoura - Oglat Askoura

Carte Oglat Beida - Oglat Beida

Carte Oglat Ben Said - Oglat Ben Said

Carte Oglat Beraber - Oglat Beraber

Carte Oglat Bou Charaf - Oglat Bou Charaf

Carte Oglat Bou Djemaa - Oglat Bou Djemaa

Carte Oglat Bou Harimek - Oglat Bou Harimek Oglat Bou Harimek, Oglat el Harimek

Carte Oglat Bou Kherdj - Oglat Bou Kherdj Oglat Bou Kherdj, Oglat Bou Krerdj

Carte Oglat Bou Khlout - Oglat Bou Khlout Oglat Bou Khlout, Oglat Bou Krlout

Carte Oglat Bou Moussa - Oglat Bou Moussa

Carte Oglat Bou Negueur - Oglat Bou Negueur

Carte Oglat Bou Rechach - Oglat Bou Rechach

Carte Oglat Chahmi - Oglat Chahmi Oglat Chahmi, Oglat Chami

Carte Oglat Chaib - Oglat Chaib Bir Chaib, Bir Chaïb, Oglat Chaib, Oglat Chaïb

Carte Oglat Cheddad Bel Ouad - Oglat Cheddad Bel Ouad Chedded, Oglat Cheddad Bel Ouad

Carte Oglat Cherrafa - Oglat Cherrafa

Carte Oglat Chora - Oglat Chora

Carte Oglat Dahane - Oglat Dahane

Carte Oglat Damrane - Oglat Damrane

Carte Oglat Derz - Oglat Derz

Carte Oglat Diab - Oglat Diab

Carte Oglat Djebria - Oglat Djebria

Carte Oglat Djedida - Oglat Djedida Oglat Djediba, Oglat Djedida, Oglat ed Djedida

Carte Oglat Djenane - Oglat Djenane

Carte Oglat Djida - Oglat Djida

Carte Oglat Douiba - Oglat Douiba

Carte Oglat Douihba - Oglat Douihba

Carte Oglat ech Chaham - Oglat ech Chaham

Carte Oglat ed Dib - Oglat ed Dib

Carte Oglat ed Diba - Oglat ed Diba

Carte Oglat el Arba - Oglat el Arba

Carte Oglat el Arouya - Oglat el Arouya

Carte Oglat el Baadja - Oglat el Baadja

Carte Oglat el Baara - Oglat el Baara

Carte Oglat el Bachir - Oglat el Bachir

Carte Oglat el Bedriat - Oglat el Bedriat

Carte Oglat el Beida - Oglat el Beida

Carte Oglat el Bekakra - Oglat el Bekakra

Carte Oglat el Betina - Oglat el Betina

Carte Oglat el Bey - Oglat el Bey Oglat el Bay, Oglat el Bey

Carte Oglat el Bikher - Oglat el Bikher Oglat el Bikher, Oglat el Bikrer

Carte Oglat el Bir - Oglat el Bir

Carte Oglat el Biter - Oglat el Biter

Carte Oglat el Botma - Oglat el Botma

Carte Oglat el Djerabaa - Oglat el Djerabaa Oglat Djeraba, Oglat el Djerabaa, Oglat el Djerabâa, Oglat el Djerata

Carte Oglat el Fekarine - Oglat el Fekarine El Fekarine, El Fékarine, Oglat el Fekarine

Carte Oglat el Ferch - Oglat el Ferch

Carte Oglat el Guetatia - Oglat el Guetatia

Carte Oglat el Hadeb - Oglat el Hadeb

Carte Oglat el Hamarou - Oglat el Hamarou

Carte Oglat el Hammam - Oglat el Hammam Oglat el Hammam, Oglet el Hamam

Carte Oglat el Hamra - Oglat el Hamra

Carte Oglat el Hamza - Oglat el Hamza

Carte Oglat el Kerch - Oglat el Kerch

Carte Oglat el Kerma - Oglat el Kerma

Carte Oglat el Kouanine - Oglat el Kouanine

Carte Oglat el Kteibat - Oglat el Kteibat

Carte Oglat el Maklal - Oglat el Maklal

Carte Oglat el Mekhennzine - Oglat el Mekhennzine Oglat el Mekhennzine, Oglat el Mekhenzine

Carte Oglat el Mezgoub - Oglat el Mezgoub

Carte Oglat el Mitta - Oglat el Mitta Bir el Mitta, Oglat el Mitta

Carte Oglat el Morra - Oglat el Morra Gadet el Morra, Oglat el Morra

Carte Oglat el Mouilah - Oglat el Mouilah

Carte Oglat el Msoussa - Oglat el Msoussa

Carte Oglat el Mzara - Oglat el Mzara

Carte Oglat en Nadja - Oglat en Nadja

Carte Oglat en Nasseur - Oglat en Nasseur Oglat Nesseur, Oglat en Nasseur

Carte Oglat er Ral - Oglat er Ral

Carte Oglat er Regaa - Oglat er Regaa

Carte Oglat er Rekhail - Oglat er Rekhail Oglat er Rekhail, Oglat er Rekhaïl, Oglat er Rekrail, Oglat er Rekraïl

Carte Oglat er Riaina - Oglat er Riaina

Carte Oglat er Rougaiba - Oglat er Rougaiba

Carte Oglat es Sennrha - Oglat es Sennrha Oglat en Sennrbra, Oglat es Senngha, Oglat es Sennrha

Carte Oglat es Snob - Oglat es Snob

Carte Oglat et Tine - Oglat et Tine

Carte Oglat ez Zkeira - Oglat ez Zkeira Oglat Ez Zkerid, Oglat Ez Zkerïd, Oglat ez Zkeira, Oglat ez Zkerira, Oglat ez Zkerïra, Oglat ez Zkeïra

Carte Oglat Ferchat Salah - Oglat Ferchat Salah

Carte Oglat Foukani - Oglat Foukani Oglat Foukani, Oglat Foukania

Carte Oglat Gladua - Oglat Gladua

Carte Oglat Guettar Tine - Oglat Guettar Tine Oglat Guettar, Oglat Guettar Tine

Carte Oglat Hamia - Oglat Hamia

Carte Oglat Jaouania - Oglat Jaouania Oglat Djouania, Oglat Jaouania, Oglat Jouania

Carte Oglat Khemtha - Oglat Khemtha

Carte Oglat Koumadia - Oglat Koumadia

Carte Oglat Labta - Oglat Labta

Carte Oglat Lakhdar - Oglat Lakhdar Oglat Lakdar, Oglat Lakhdar, Oglat Lakrdar

Carte Oglat Leftah - Oglat Leftah Oglat Leflah, Oglat Leftah

Carte Oglat Marhboura - Oglat Marhboura Oglat Magboura, Oglat Maghboura, Oglat Marhboura

Carte Oglat Mbarka - Oglat Mbarka Oglat Embarka, Oglat Mbarka

Carte Oglat Mechra el Amar - Oglat Mechra el Amar

Carte Oglat Melaga - Oglat Melaga

Carte Oglat Mohammed - Oglat Mohammed Oglat Mohammed, Oguilet Mohammed

Carte Oglat Moussa - Oglat Moussa

Carte Oglat Msiaid - Oglat Msiaid Oglat Msiad, Oglat Msiaid, Oglat Msiaïd

Carte Oglat Nemencha - Oglat Nemencha

Carte Oglat Noumerat - Oglat Noumerat Oglat Noumerat, Oglat Noumerate

Carte Oglat Oulad Mahboub - Oglat Oulad Mahboub

Carte Oglat Oulad Serour - Oglat Oulad Serour Oglat Oued Serour, Oglat Oulad Serour

Carte Oglat Ouled es Serour - Oglat Ouled es Serour

Carte Oglat Ouled Yakoub - Oglat Ouled Yakoub Oglat Oud Yacoub, Oglat Ould Jacoub, Oglat Ouled Yakoub, Oglet Ould Yacoub

Carte Oglat Rahmadia - Oglat Rahmadia

Carte Oglat Raiala - Oglat Raiala Oglat Raiala, Oglat Raiata, Oglat Raïala, Oglat Raïata

Carte Oglat Rhamna - Oglat Rhamna Oglat Rehamna, Oglat Rhamna

Carte Oglat Rhelel - Oglat Rhelel

Carte Oglat Rhezneta - Oglat Rhezneta

Carte Oglat Sbita - Oglat Sbita

Carte Oglat Sbot - Oglat Sbot

Carte Oglat Seila - Oglat Seila

Carte Oglat Selga - Oglat Selga Oglat Selga, Oglat Solga Selga

Carte Oglat Sidi Mannsar - Oglat Sidi Mannsar

Carte Oglat Siouf - Oglat Siouf

Carte Oglat Souamch - Oglat Souamch

Carte Oglat Taerziza - Oglat Taerziza

Carte Oglat Tahtani - Oglat Tahtani Oglat Tahtani, Oglat Tahtania

Carte Oglat Tahtania el Hassei - Oglat Tahtania el Hassei Oglat Tahtania, Oglat Tahtania el Hassei, Oglat Tahtania el Hasseï

Carte Oglat Taoussara - Oglat Taoussara Oglat Taoussara, Oglat Taoussera

Carte Oglat Tidmamine - Oglat Tidmamine Oglat Tidmamine, Tidmamine

Carte Oglat Tirherazine - Oglat Tirherazine

Carte Oglat Touila - Oglat Touila

Carte Oglat Traifia - Oglat Traifia

Carte Oglat Triaa - Oglat Triaa

Carte Oglat Troudi - Oglat Troudi Oglat Trouai, Oglat Troudi

Carte Oglat Zerig Chaaba - Oglat Zerig Chaaba

Carte Oglat Zerig el Oued - Oglat Zerig el Oued

Carte Oglat Ziar - Oglat Ziar

Carte Oglat Zourz - Oglat Zourz

Carte Oglet Arbia - Oglet Arbia

Carte Oglet Chouiouia - Oglet Chouiouia

Carte Oglet ed Dek - Oglet ed Dek

Carte Oglet el Guedid - Oglet el Guedid

Carte Oglet el Heussai - Oglet el Heussai

Carte Oglet Oum ed Dedi - Oglet Oum ed Dedi Oglat Oum ed Deli, Oglet Oum ed Dedi

Carte Oglet Tlilet - Oglet Tlilet

Carte Oguerramane - Oguerramane

Carte Ohanet - Ohanet

Carte Om Tefrakh - Om Tefrakh Om Tefrakh, Oum Tefrakh

Carte Ommaissia - Ommaissia El Khouadria, Ommaissia, Ommaïssia

Carte Ong ed Diba - Ong ed Diba

Carte Ong el Kebrit - Ong el Kebrit

Carte Oran - Oran ORN, Ora, Oran, Orà, Orán, Ouahran, Wahran, Wahr?n, whran, wlayt whran, ????, ?????, ????? ?????, ?????

Carte Oran / Es Senia - Oran / Es Senia DAOO, ORN

Carte Oran/Es Senia - Oran/Es Senia

Carte Oran/Tafaraoui - Oran/Tafaraoui DAOL, TAF

Carte Ord Inifeg - Ord Inifeg

Carte Orhroud Ahmed Ben Bou Haous - Orhroud Ahmed Ben Bou Haous

Carte Orhroud Ali - Orhroud Ali

Carte Orhroud Amri Yet - Orhroud Amri Yet

Carte Orhroud Bafka - Orhroud Bafka

Carte Orhroud Bel Djediane - Orhroud Bel Djediane

Carte Orhroud Bel Hadj Azzouz - Orhroud Bel Hadj Azzouz

Carte Orhroud Bel Teboul - Orhroud Bel Teboul

Carte Orhroud Bou Guefa - Orhroud Bou Guefa

Carte Orhroud Bou Hadoura - Orhroud Bou Hadoura

Carte Orhroud Bou Khelala - Orhroud Bou Khelala

Carte Orhroud Bou Safia - Orhroud Bou Safia

Carte Orhroud Boulahia - Orhroud Boulahia

Carte Orhroud Chabet - Orhroud Chabet

Carte Orhroud Cheheb - Orhroud Cheheb

Carte Orhroud Chouf - Orhroud Chouf Oghroud Chouf, Orhroud Chouf

Carte Orhroud Damrane - Orhroud Damrane

Carte Orhroud Djedaria - Orhroud Djedaria

Carte Orhroud el Abeb - Orhroud el Abeb

Carte Orhroud el Aoun Allah el Rharbi - Orhroud el Aoun Allah el Rharbi

Carte Orhroud el Aziba - Orhroud el Aziba

Carte Orhroud el Berkine - Orhroud el Berkine

Carte Orhroud el Guedra - Orhroud el Guedra

Carte Orhroud el Kahal - Orhroud el Kahal

Carte Orhroud el Kelb - Orhroud el Kelb

Carte Orhroud el Khoab - Orhroud el Khoab

Carte Orhroud el Ktir - Orhroud el Ktir

Carte Orhroud el Mekha - Orhroud el Mekha

Carte Orhroud el Mrazigat - Orhroud el Mrazigat

Carte Orhroud el Oudjdi - Orhroud el Oudjdi

Carte Orhroud en Nezla - Orhroud en Nezla

Carte Orhroud er Rih - Orhroud er Rih

Carte Orhroud et Tmar - Orhroud et Tmar

Carte Orhroud et Toumiat - Orhroud et Toumiat

Carte Orhroud ez Zaouia - Orhroud ez Zaouia

Carte Orhroud Guelb el Gara - Orhroud Guelb el Gara

Carte Orhroud Guettaf - Orhroud Guettaf

Carte Orhroud Harcha - Orhroud Harcha

Carte Orhroud Mahaboula - Orhroud Mahaboula

Carte Orhroud Mezrag - Orhroud Mezrag

Carte Orhroud Mzalib - Orhroud Mzalib

Carte Orhroud Nba - Orhroud Nba

Carte Orhroud Nouabi - Orhroud Nouabi

Carte Orhroud Oured - Orhroud Oured

Carte Orhroud Retmaia - Orhroud Retmaia

Carte Orhroud Saida - Orhroud Saida

Carte Orhroud Settar - Orhroud Settar

Carte Orhroud Sfina - Orhroud Sfina

Carte Orhroud Sidi Tayeb - Orhroud Sidi Tayeb Orhroud Sidi Taieb, Orhroud Sidi Tayeb, Orhroud Sidi Taïeb

Carte Orhroud Torba - Orhroud Torba

Carte Orhroud Touil - Orhroud Touil

Carte Orleansville - Orleansville

Carte Ou Mad - Ou Mad

Carte Ou-en-Aguedda - Ou-en-Aguedda Ou er Aguedda, Ou-en-Aguedda

Carte Oua Hakane - Oua Hakane

Carte Oua Helledjene - Oua Helledjene

Carte Oua Mala - Oua Mala

Carte Oua Tirekfine - Oua Tirekfine Oua Tirekfine

Carte Oua-n-Bedjedjene - Oua-n-Bedjedjene Oua-n-Bedjedjene, Ouane Bedjedjene

Carte Oua-n-Bedou - Oua-n-Bedou

Carte Oua-n-Dimeta - Oua-n-Dimeta

Carte Oua-n-Ekendoukher - Oua-n-Ekendoukher

Carte Oua-n-el Gafgaf - Oua-n-el Gafgaf

Carte Oua-n-Farfar - Oua-n-Farfar

Carte Oua-n-Galadima - Oua-n-Galadima

Carte Oua-n-Houdi - Oua-n-Houdi Oua-n-Houdi, Ouane Houdi

Carte Oua-n-Ibtane - Oua-n-Ibtane Oua-n-Ibtane, Ouane Ibtane

Carte Oua-n-Imazellaouene - Oua-n-Imazellaouene Imazellaouene, Oua-n-Imazellaouene, Ouane Imazellaouene

Carte Oua-n-Nagguene - Oua-n-Nagguene

Carte Oua-n-Ou Hanou - Oua-n-Ou Hanou

Carte Oua-n-Ousmane - Oua-n-Ousmane Oua-n-Ousmane, Ouane Ousmane

Carte Oua-n-Rechla - Oua-n-Rechla

Carte Oua-n-Sedoukane - Oua-n-Sedoukane Oua-n-Sedoukane, Ouane Sedoukane

Carte Oua-n-Taredjeli - Oua-n-Taredjeli

Carte Oua-n-Tatahit - Oua-n-Tatahit

Carte Oua-n-Tazzait - Oua-n-Tazzait

Carte Oua-n-Tebeni - Oua-n-Tebeni

Carte Oua-n-Telematount - Oua-n-Telematount

Carte Oua-n-Teressere - Oua-n-Teressere Oua-n-Teressere, Ouane Teressere

Carte Oua-n-Tessabakot - Oua-n-Tessabakot

Carte Oua-n-ti-n-Barek - Oua-n-ti-n-Barek Oua-n-ti-n-Barek, Ouane Tin Barek

Carte Oua-n-Tourha - Oua-n-Tourha

Carte Oua-n-T'Bakatine - Oua-n-T'Bakatine

Carte Ouachouache - Ouachouache

Carte Ouad Ziza - Ouad Ziza

Carte Ouada - Ouada

Carte Ouadhia - Ouadhia Ouadhia

Carte Ouadine er Rokna - Ouadine er Rokna

Carte Ouadjda - Ouadjda

Carte Ouahila - Ouahila

Carte Ouahrani - Ouahrani Douar el Ouahrani, Douar el Ouâhrâni, Ouahrani

Carte Ouakda - Ouakda

Carte Ouakli - Ouakli

Carte Oualil - Oualil

Carte Ouallen - Ouallen

Carte Ouallene - Ouallene Bordj Ouallen, Ouallen, Ouallene

Carte Ouamane Yala - Ouamane Yala

Carte Ouameni Sidi Said - Ouameni Sidi Said

Carte Ouamri - Ouamri Borely-la-Sapie, Borély-la-Sapie, Ouamri, Ouamria

Carte Ouamria - Ouamria

Carte Ouar Mouloud - Ouar Mouloud

Carte Ouarahossenete - Ouarahossenete

Carte Ouarassene - Ouarassene Ouaracene, Ouarassene

Carte Ouarda - Ouarda

Carte Ouardia - Ouardia Douar Ouardia, Ouardia

Carte Ouarghia - Ouarghia

Carte Ouargla - Ouargla OGX, Ouargla, Quargla, Warkala, Warqla, wrqlt, ?????

Carte Ouargla longwave transmitter, Mast Middle - Ouargla longwave transmitter, Mast Middle

Carte Ouargla longwave transmitter, Mast North - Ouargla longwave transmitter, Mast North

Carte Ouargla longwave transmitter, Mast South - Ouargla longwave transmitter, Mast South

Carte Ouarizane - Ouarizane Ouarizan, Ouarizane

Carte Ouarka - Ouarka

Carte Ouarnasseur - Ouarnasseur Ouarnasseur, Ournasseur

Carte Ouarourout - Ouarourout

Carte Ouarrag - Ouarrag

Carte Ouarsakfal - Ouarsakfal

Carte Ouarsisene - Ouarsisene

Carte Ouassa Abd el Moula - Ouassa Abd el Moula

Carte Ouatelene - Ouatelene Ouatelene, Ouatélene, Oued oua-n-Telene

Carte Ouazane - Ouazane

Carte Oubedene - Oubedene

Carte Oubellil - Oubellil

Carte Oubezir - Oubezir Mont Oubezer, Oubezier, Oubezir, Oûbezier, Oûbezir

Carte Ouchanene - Ouchanene

Carte Oucht Essedra - Oucht Essedra

Carte Oud Aissa - Oud Aissa

Carte Oud Mellane - Oud Mellane

Carte Oudarat - Oudarat

Carte Oudei Dib Chergui - Oudei Dib Chergui

Carte Oudei ed Diab - Oudei ed Diab

Carte Oudei el Biod - Oudei el Biod

Carte Oudei es Seder - Oudei es Seder

Carte Oudei Jouimel - Oudei Jouimel

Carte Oudei Rhazal - Oudei Rhazal

Carte Oudei Seder - Oudei Seder

Carte Oudei Sedra - Oudei Sedra

Carte Oudei Trek - Oudei Trek

Carte Oudeiat Chouikh - Oudeiat Chouikh Oudeiat Chouikh, Oudeiat Chouikr, Oudeïat Chouikh, Oudeïat Chouïkr

Carte Oudeinat el Klab - Oudeinat el Klab

Carte Oudia el Khzim - Oudia el Khzim Oudia el Khzim, Oudiane el Khzim

Carte Oudian I-n-Kel Air - Oudian I-n-Kel Air

Carte Oudian I-n-Rokkan - Oudian I-n-Rokkan

Carte Oudian Iraldiouine - Oudian Iraldiouine

Carte Oudian Tersi - Oudian Tersi

Carte Oudiane Bahr - Oudiane Bahr

Carte Oudiane Bou Temmach - Oudiane Bou Temmach

Carte Oudiane Chebkaiat - Oudiane Chebkaiat

Carte Oudiane Cheheb - Oudiane Cheheb

Carte Oudiane el Askaf - Oudiane el Askaf

Carte Oudiane el Batem - Oudiane el Batem

Carte Oudiane el Maiz - Oudiane el Maiz

Carte Oudiane i-n-Effene - Oudiane i-n-Effene

Carte Oudiane i-n-Oufnane - Oudiane i-n-Oufnane

Carte Oudiane Ibel Oudat - Oudiane Ibel Oudat

Carte Oudiane Ilezanat - Oudiane Ilezanat

Carte Oudiane Imedjoussasse - Oudiane Imedjoussasse

Carte Oudiane Lemkhaf - Oudiane Lemkhaf

Carte Oudiane Nhaiz - Oudiane Nhaiz

Carte Oudiane Terzekkouline - Oudiane Terzekkouline

Carte Oudiane ti-n-Teddamate - Oudiane ti-n-Teddamate

Carte Oudiat ed Dib - Oudiat ed Dib

Carte Oudiet Sebouba - Oudiet Sebouba

Carte Oudj Ahmera - Oudj Ahmera

Carte Oudjah Deff - Oudjah Deff

Carte Oudjida - Oudjida

Carte Oudjmidene - Oudjmidene

Carte Oudliene - Oudliene

Carte Oudoume - Oudoume

Carte Oudrak - Oudrak

Carte Oudrharh - Oudrharh Oudrhar, Oudrharh

Carte Oudriss - Oudriss

Carte Oued a-n-Emerherou - Oued a-n-Emerherou

Carte Oued Aachour - Oued Aachour

Carte Oued Aaferd - Oued Aaferd

Carte Oued Aakak - Oued Aakak

Carte Oued Aakoucha - Oued Aakoucha

Carte Oued Abadene - Oued Abadene

Carte Oued Abadou - Oued Abadou

Carte Oued Abakkar - Oued Abakkar

Carte Oued Abalessa - Oued Abalessa

Carte Oued Abaras - Oued Abaras

Carte Oued Abass - Oued Abass

Carte Oued Abbaz - Oued Abbaz

Carte Oued Abbou Edehane - Oued Abbou Edehane

Carte Oued Abd el Achir - Oued Abd el Achir

Carte Oued Abd el Hag - Oued Abd el Hag

Carte Oued Abd el Kaoui - Oued Abd el Kaoui

Carte Oued Abd el Krim - Oued Abd el Krim

Carte Oued Abd el Medjid - Oued Abd el Medjid

Carte Oued Abd el Moula - Oued Abd el Moula

Carte Oued Abd er Rahmane - Oued Abd er Rahmane

Carte Oued Abd er Razeg - Oued Abd er Razeg

Carte Oued Abda - Oued Abda

Carte Oued Abdallah - Oued Abdallah Oued Abdallah, Oued Abdallah Ben Ali

Carte Oued Abdallah Ben Ali - Oued Abdallah Ben Ali

Carte Oued Abdel Goui - Oued Abdel Goui

Carte Oued Abdelkader - Oued Abdelkader

Carte Oued Abdi - Oued Abdi

Carte Oued Abdjaz - Oued Abdjaz

Carte Oued Abdous - Oued Abdous

Carte Oued Abdouz - Oued Abdouz

Carte Oued Abed - Oued Abed

Carte Oued Abiod - Oued Abiod

Carte Oued Aborah - Oued Aborah

Carte Oued Aboucha - Oued Aboucha

Carte Oued Aboutegui - Oued Aboutegui

Carte Oued Abroua - Oued Abroua

Carte Oued Abter Chergui - Oued Abter Chergui

Carte Oued Abter Oustani - Oued Abter Oustani

Carte Oued Achouane - Oued Achouane

Carte Oued Ackouane - Oued Ackouane

Carte Oued Ad - Oued Ad

Carte Oued Adadjene - Oued Adadjene

Carte Oued Adaf - Oued Adaf Ad'Af, Ad’Af, Oued Adaf

Carte Oued Adar-n-Ou Amane - Oued Adar-n-Ou Amane Oued Adar-n-Ou Amane, Oued Adarnouamene

Carte Oued Adarou - Oued Adarou

Carte Oued Addad - Oued Addad

Carte Oued Addebel - Oued Addebel

Carte Oued Addiladjel - Oued Addiladjel

Carte Oued Adedjedadj - Oued Adedjedadj Oued Adedjadadj, Oued Adedjedadj

Carte Oued Adeffi - Oued Adeffi

Carte Oued Adero - Oued Adero

Carte Oued Adiadial - Oued Adiadial

Carte Oued Adieladial - Oued Adieladial

Carte Oued Adientour - Oued Adientour Oued Adientour, Oued Aguentor

Carte Oued Adja - Oued Adja

Carte Oued Adjanadjane - Oued Adjanadjane

Carte Oued Adjane Adjane - Oued Adjane Adjane

Carte Oued Adje - Oued Adje

Carte Oued Adjed - Oued Adjed

Carte Oued Adjelane - Oued Adjelane

Carte Oued Adjelil - Oued Adjelil

Carte Oued Adjemet - Oued Adjemet

Carte Oued Adjendjoum - Oued Adjendjoum

Carte Oued Adjevil - Oued Adjevil

Carte Oued Adjoul - Oued Adjoul

Carte Oued Adjriouene - Oued Adjriouene

Carte Oued Adouane - Oued Adouane

Carte Oued Adrar n'Ou Djakkane - Oued Adrar n'Ou Djakkane Oued Adrar In'Ou Djakkane, Oued Adrar In’Ou Djakkane, Oued Adrar n'Ou Djakkane, Oued Adrar n'Ou Jakkane, Oued Adrar n’Ou Djakkane, Oued Adrar n’Ou Jakkane

Carte Oued Adzim - Oued Adzim

Carte Oued Aerdar - Oued Aerdar Oued Aerdar

Carte Oued Afaghfalagh - Oued Afaghfalagh

Carte Oued Afaifo - Oued Afaifo

Carte Oued Afar - Oued Afar

Carte Oued Afara-n-Imnes - Oued Afara-n-Imnes

Carte Oued Afarene - Oued Afarene

Carte Oued Afene - Oued Afene

Carte Oued Afensou - Oued Afensou

Carte Oued Afflisses - Oued Afflisses Oued Afflisses, Oued Afflissess, Oued Aflisses

Carte Oued Afisfas - Oued Afisfas Oued Afisfas, Oued Afisfes

Carte Oued Afoudj - Oued Afoudj

Carte Oued Afra - Oued Afra

Carte Oued Afsas - Oued Afsas

Carte Oued Agdaodaou - Oued Agdaodaou

Carte Oued Agfifi - Oued Agfifi Oued Agfifi, Oued Agtiti

Carte Oued Aggar - Oued Aggar

Carte Oued Aghbal - Oued Aghbal

Carte Oued Aglagal - Oued Aglagal

Carte Oued Aglagal Bou Sarda - Oued Aglagal Bou Sarda

Carte Oued Aglagal et Tahtani - Oued Aglagal et Tahtani

Carte Oued Aglaglal - Oued Aglaglal

Carte Oued Agoules - Oued Agoules

Carte Oued Agrioun - Oued Agrioun Oued Agrioum, Oued Agrioun, Oued Agroum

Carte Oued Agroun - Oued Agroun

Carte Oued Aguagui - Oued Aguagui

Carte Oued Aguedda - Oued Aguedda

Carte Oued Aguellou - Oued Aguellou

Carte Oued Aguelmam - Oued Aguelmam

Carte Oued Aguelmam Ararhen - Oued Aguelmam Ararhen

Carte Oued Aguelmam el Rha - Oued Aguelmam el Rha Oued Aguelmam el Rha, Oued Aguelmame el Rha

Carte Oued Aguelmam Eskoum - Oued Aguelmam Eskoum Oued Ag Eskoum, Oued Aguelmam Eskoum

Carte Oued Aguelmam Maamar - Oued Aguelmam Maamar Oued Ag Maamar, Oued Aguelmam Maamar

Carte Oued Aguelmam Maamar el Akhal - Oued Aguelmam Maamar el Akhal Oued Ag Maamar el Akhal, Oued Aguelmam Maamar el Akhal

Carte Oued Aguemour - Oued Aguemour

Carte Oued Aguergour - Oued Aguergour

Carte Oued Aguerrour - Oued Aguerrour

Carte Oued Aha oui-n-Aka - Oued Aha oui-n-Aka

Carte Oued Aha-n-Souri Abarekka - Oued Aha-n-Souri Abarekka

Carte Oued Ahaddouch - Oued Ahaddouch

Carte Oued Ahaguit - Oued Ahaguit

Carte Oued Ahambatou - Oued Ahambatou Ambatou, Oued Ahambatou

Carte Oued Ahanabaroug - Oued Ahanabaroug Oued Ahanabaroug, Oued Ahanabarougue

Carte Oued Ahanerek - Oued Ahanerek

Carte Oued Ahansa-n-Mokhammed - Oued Ahansa-n-Mokhammed

Carte Oued Ahara - Oued Ahara

Carte Oued Aharhar - Oued Aharhar Ararrar, Oued Aharhar

Carte Oued Ahates - Oued Ahates

Carte Oued Ahateus - Oued Ahateus

Carte Oued Ahelef - Oued Ahelef

Carte Oued Ahelledjem - Oued Ahelledjem

Carte Oued Ahendedar - Oued Ahendedar

Carte Oued Ahensa-n-Beriene - Oued Ahensa-n-Beriene

Carte Oued Ahetes - Oued Ahetes

Carte Oued Ahiersa - Oued Ahiersa

Carte Oued Ahimer - Oued Ahimer

Carte Oued Ahmar - Oued Ahmar

Carte Oued Ahmar Keddo - Oued Ahmar Keddo

Carte Oued Ahmed Ben Mohammed - Oued Ahmed Ben Mohammed

Carte Oued Ahor - Oued Ahor

Carte Oued Ahorene - Oued Ahorene

Carte Oued Ahouaredj - Oued Ahouaredj

Carte Oued Ahra - Oued Ahra

Carte Oued Ahrzerouftis - Oued Ahrzerouftis

Carte Oued Ahtess - Oued Ahtess

Carte Oued Ahtesse - Oued Ahtesse

Carte Oued Aich - Oued Aich

Carte Oued Aicha - Oued Aicha

Carte Oued Aichouch - Oued Aichouch

Carte Oued Aid - Oued Aid

Carte Oued Aiddirene - Oued Aiddirene

Carte Oued Ain Abacha - Oued Ain Abacha

Carte Oued Ain Alama - Oued Ain Alama

Carte Oued Ain Amara - Oued Ain Amara

Carte Oued Ain Arous - Oued Ain Arous

Carte Oued Ain Belkacem - Oued Ain Belkacem

Carte Oued Ain Ben Said - Oued Ain Ben Said

Carte Oued Ain Bouziane - Oued Ain Bouziane

Carte Oued Ain Chabro - Oued Ain Chabro

Carte Oued Ain Cheikh - Oued Ain Cheikh

Carte Oued Ain Dahmane - Oued Ain Dahmane

Carte Oued Ain ed Dar - Oued Ain ed Dar

Carte Oued Ain Eddem - Oued Ain Eddem

Carte Oued Ain el Arar - Oued Ain el Arar

Carte Oued Ain el Asfour - Oued Ain el Asfour

Carte Oued Ain el Bey - Oued Ain el Bey

Carte Oued Ain el Frid - Oued Ain el Frid

Carte Oued Ain el Hadjar - Oued Ain el Hadjar

Carte Oued Ain el Hamra - Oued Ain el Hamra

Carte Oued Ain el Kahla - Oued Ain el Kahla

Carte Oued Ain el Khalloua - Oued Ain el Khalloua

Carte Oued Ain el Malha - Oued Ain el Malha

Carte Oued Ain el Melha - Oued Ain el Melha

Carte Oued Ain ez Zana - Oued Ain ez Zana

Carte Oued Ain Frimir - Oued Ain Frimir

Carte Oued Ain Ghorab - Oued Ain Ghorab

Carte Oued Ain Guerfa - Oued Ain Guerfa

Carte Oued Ain Guesba - Oued Ain Guesba

Carte Oued Ain Haddada - Oued Ain Haddada

Carte Oued Ain Hallouf - Oued Ain Hallouf Oued Ain Hallouf, Oued Aine Hallouf, Oued Aïn Hallouf, Oued Aïne Hallouf

Carte Oued Ain Korchi - Oued Ain Korchi

Carte Oued Ain Saada - Oued Ain Saada

Carte Oued Ain Safsaf - Oued Ain Safsaf

Carte Oued Ain Saltane - Oued Ain Saltane

Carte Oued Ain Sedra - Oued Ain Sedra

Carte Oued Ain Semmadhen - Oued Ain Semmadhen

Carte Oued Ain Sidi Ahmed - Oued Ain Sidi Ahmed

Carte Oued Ain Sidi Ali - Oued Ain Sidi Ali

Carte Oued Ain Smat - Oued Ain Smat

Carte Oued Ain Soltane - Oued Ain Soltane

Carte Oued Ain Zarached - Oued Ain Zarached

Carte Oued Aine Malah - Oued Aine Malah

Carte Oued Aioun el Beranis - Oued Aioun el Beranis

Carte Oued Aisehber - Oued Aisehber

Carte Oued Aissa - Oued Aissa

Carte Oued Aissa Aziane - Oued Aissa Aziane

Carte Oued Aissa Ben el Kharef - Oued Aissa Ben el Kharef

Carte Oued Aissaour - Oued Aissaour

Carte Oued Aissi - Oued Aissi

Carte Oued Ait Hounrene - Oued Ait Hounrene

Carte Oued Ait Meouene - Oued Ait Meouene

Carte Oued Aitessine - Oued Aitessine

Carte Oued Aithounarhene - Oued Aithounarhene

Carte Oued Aitou - Oued Aitou

Carte Oued Ajerma - Oued Ajerma

Carte Oued Akafor - Oued Akafor Ouad Akafor, Oued Akafor

Carte Oued Akaifou - Oued Akaifou

Carte Oued Akar - Oued Akar

Carte Oued Akarchechou - Oued Akarchechou

Carte Oued Akba - Oued Akba

Carte Oued Akefou - Oued Akefou

Carte Oued Akerkour - Oued Akerkour

Carte Oued Akerrich - Oued Akerrich Oued Akerrich, Oued Akirricha

Carte Oued Akha - Oued Akha Oued Akha, Oued El-Akra

Carte Oued Akhouilet - Oued Akhouilet

Carte Oued Akikert - Oued Akikert

Carte Oued Akil - Oued Akil

Carte Oued Akkene - Oued Akkene

Carte Oued Aklene - Oued Aklene

Carte Oued Akomak - Oued Akomak

Carte Oued Akoum - Oued Akoum Oued Akoum, Oued el Hakoum

Carte Oued Akrout - Oued Akrout

Carte Oued Aktnantablat - Oued Aktnantablat

Carte Oued Alala - Oued Alala Oued Alala, Oued Attala

Carte Oued Alaou - Oued Alaou

Carte Oued Aleb el Khezil - Oued Aleb el Khezil

Carte Oued Alef el Djema - Oued Alef el Djema

Carte Oued Ali - Oued Ali

Carte Oued Ali Ben Abdallah - Oued Ali Ben Abdallah

Carte Oued Ali Ben Brahim - Oued Ali Ben Brahim

Carte Oued Ali Mbarka - Oued Ali Mbarka

Carte Oued Ali Messaoud Guliet Cherait - Oued Ali Messaoud Guliet Cherait

Carte Oued Aliminou - Oued Aliminou

Carte Oued Aliouche - Oued Aliouche

Carte Oued Allaga - Oued Allaga

Carte Oued Allal - Oued Allal

Carte Oued Allala - Oued Allala Oued Allala, Oued Allalah, Oued Allalia

Carte Oued Allalah - Oued Allalah

Carte Oued Allendaoui - Oued Allendaoui

Carte Oued Allouch - Oued Allouch

Carte Oued Aloha - Oued Aloha

Carte Oued Alouhadj - Oued Alouhadj

Carte Oued Aloulhal - Oued Aloulhal

Carte Oued Alyem - Oued Alyem

Carte Oued Amadit - Oued Amadit

Carte Oued Amadjar - Oued Amadjar

Carte Oued Amadjeri - Oued Amadjeri

Carte Oued Amadjerza - Oued Amadjerza

Carte Oued Amadouaz - Oued Amadouaz

Carte Oued Amadror - Oued Amadror Oued Amador, Oued Amadror

Carte Oued Amakana - Oued Amakana

Carte Oued Amali - Oued Amali

Carte Oued Aman Ouded Nine - Oued Aman Ouded Nine

Carte Oued Amar - Oued Amar

Carte Oued Amar Ben Ali - Oued Amar Ben Ali

Carte Oued Amar Ou Moussa - Oued Amar Ou Moussa

Carte Oued Amarad - Oued Amarad

Carte Oued Amarakou oua-n-Tisemt - Oued Amarakou oua-n-Tisemt

Carte Oued Amarhalrhal - Oued Amarhalrhal

Carte Oued Amarhou - Oued Amarhou

Carte Oued Amarrakou - Oued Amarrakou

Carte Oued Amasara - Oued Amasara

Carte Oued Amasralad - Oued Amasralad Oued Amaraslad, Oued Amasralad

Carte Oued Amassara - Oued Amassara

Carte Oued Amassasse - Oued Amassasse

Carte Oued Amassine - Oued Amassine

Carte Oued Amastane - Oued Amastane

Carte Oued Amazza - Oued Amazza

Carte Oued Ambaradjene - Oued Ambaradjene

Carte Oued Amboulguem - Oued Amboulguem

Carte Oued Ambrabhile - Oued Ambrabhile

Carte Oued Amedar - Oued Amedar

Carte Oued Amederh - Oued Amederh

Carte Oued Amedou - Oued Amedou

Carte Oued Ameicha - Oued Ameicha

Carte Oued Amejjene - Oued Amejjene

Carte Oued Amekni - Oued Amekni

Carte Oued Amendjaj - Oued Amendjaj

Carte Oued Amenenad - Oued Amenenad

Carte Oued Amesmesa oua-n-Afarfar - Oued Amesmesa oua-n-Afarfar

Carte Oued Amesmesa oua-n-Techamaq - Oued Amesmesa oua-n-Techamaq

Carte Oued Ameur - Oued Ameur

Carte Oued Amezegui - Oued Amezegui

Carte Oued Amezeguine - Oued Amezeguine

Carte Oued Amezrouk - Oued Amezrouk

Carte Oued Amezzar oua-n-ti-n-Ter'or - Oued Amezzar oua-n-ti-n-Ter'or Imerzzarene-t-in-Rerhoh, Imezzerene-ti-n-Rerhoh, Oued Amezzar oua-n-ti-n-Ter'or, Oued Amezzar oua-n-ti-n-Ter’or

Carte Oued Amguiousses - Oued Amguiousses

Carte Oued Amiguier - Oued Amiguier

Carte Oued Amilek - Oued Amilek Irhzer Ammilek, Oued Amilek

Carte Oued Amiok - Oued Amiok

Carte Oued Amirzaguene - Oued Amirzaguene

Carte Oued Amizour - Oued Amizour

Carte Oued Ammar - Oued Ammar Oued Ameur, Oued Ammar

Carte Oued Amor - Oued Amor

Carte Oued Amour - Oued Amour

Carte Oued Amrane - Oued Amrane

Carte Oued Amraoua - Oued Amraoua Chaba er Rai, Chaba er Raï, Oued Amraoua

Carte Oued Amrha - Oued Amrha

Carte Oued Amri Ghebal - Oued Amri Ghebal

Carte Oued Amsarha - Oued Amsarha

Carte Oued Amsenan't - Oued Amsenan't

Carte Oued Amser - Oued Amser

Carte Oued Amssa - Oued Amssa

Carte Oued An Eseffa - Oued An Eseffa

Carte Oued Anahar - Oued Anahar

Carte Oued Anahor - Oued Anahor

Carte Oued Analak - Oued Analak

Carte Oued Anasseur - Oued Anasseur Oued Anasser, Oued Anasseur

Carte Oued Anat el Gour - Oued Anat el Gour

Carte Oued Anchal - Oued Anchal

Carte Oued Anebdour - Oued Anebdour

Carte Oued Anesbarraka - Oued Anesbarraka

Carte Oued Anfeg - Oued Anfeg

Carte Oued Annbar - Oued Annbar

Carte Oued Anndjar - Oued Anndjar

Carte Oued Annfif - Oued Annfif

Carte Oued Anous Baraka - Oued Anous Baraka

Carte Oued Anrhenyed - Oued Anrhenyed

Carte Oued Anseiet - Oued Anseiet

Carte Oued Ansit - Oued Ansit

Carte Oued Ansor Mansour - Oued Ansor Mansour

Carte Oued Aokassit - Oued Aokassit

Carte Oued Aou Diedaft - Oued Aou Diedaft

Carte Oued Aou Sedjoune - Oued Aou Sedjoune

Carte Oued Aouachria - Oued Aouachria

Carte Oued Aouai - Oued Aouai

Carte Oued Aouarheleur - Oued Aouarheleur

Carte Oued Aouassis - Oued Aouassis

Carte Oued Aoubarraka - Oued Aoubarraka

Carte Oued Aouch Laagueb - Oued Aouch Laagueb

Carte Oued Aoudanet - Oued Aoudanet

Carte Oued Aoudjerar - Oued Aoudjerar

Carte Oued Aoudjeroou - Oued Aoudjeroou

Carte Oued Aouere - Oued Aouere

Carte Oued Aouinet el Hamara - Oued Aouinet el Hamara Oued Aouinet el Hamara, Oued el Ahmar, Oued el Hamar

Carte Oued Aouissak - Oued Aouissak

Carte Oued Aoukkeli - Oued Aoukkeli

Carte Oued Aoulad Slimane - Oued Aoulad Slimane

Carte Oued Aoulaoul - Oued Aoulaoul

Carte Oued Aoulasse - Oued Aoulasse

Carte Oued Aouleggui - Oued Aouleggui

Carte Oued Aoulik - Oued Aoulik

Carte Oued Aoulilamane - Oued Aoulilamane

Carte Oued Aoun - Oued Aoun

Carte Oued Aourati - Oued Aourati

Carte Oued Aourir - Oued Aourir

Carte Oued Aoussi Yedane - Oued Aoussi Yedane

Carte Oued Aoussokrarene - Oued Aoussokrarene

Carte Oued Aouzergui - Oued Aouzergui

Carte Oued Araar - Oued Araar

Carte Oued Arada - Oued Arada

Carte Oued Aradj - Oued Aradj

Carte Oued Araftalis - Oued Araftalis

Carte Oued Araguene - Oued Araguene

Carte Oued Arai - Oued Arai

Carte Oued Araj - Oued Araj Oued Aradj, Oued Araj

Carte Oued Arakad - Oued Arakad

Carte Oued Arara - Oued Arara

Carte Oued Arassousse - Oued Arassousse

Carte Oued Arbaine Cheikh - Oued Arbaine Cheikh

Carte Oued Arbatach - Oued Arbatach

Carte Oued Arbi - Oued Arbi

Carte Oued Ardjet Sfa - Oued Ardjet Sfa

Carte Oued Ardjila - Oued Ardjila

Carte Oued Arefdji - Oued Arefdji Oued Arefdji, Oued Arefji

Carte Oued Arendoum - Oued Arendoum

Carte Oued Argoub ed Diab - Oued Argoub ed Diab

Carte Oued Argoub et Tamar - Oued Argoub et Tamar

Carte Oued Arh-n-Abrar - Oued Arh-n-Abrar Oued Arar Abrar, Oued Arar Aurar, Oued Arh-n-Abrar

Carte Oued Arhlal - Oued Arhlal

Carte Oued Ariaret - Oued Ariaret

Carte Oued Arich ed Dib - Oued Arich ed Dib Oued Arich ed Dib, Oued Ariched

Carte Oued Arid - Oued Arid

Carte Oued Ariguib - Oued Ariguib

Carte Oued Arirer - Oued Arirer

Carte Oued Arkakab - Oued Arkakab

Carte Oued Arket - Oued Arket

Carte Oued Arlal - Oued Arlal

Carte Oued Aroh - Oued Aroh

Carte Oued Arokam - Oued Arokam

Carte Oued Aroua - Oued Aroua

Carte Oued Aroui - Oued Aroui

Carte Oued Arour - Oued Arour

Carte Oued Arouri - Oued Arouri

Carte Oued Aroussa - Oued Aroussa

Carte Oued Arraguene - Oued Arraguene Oued Arragen, Oued Arraguene

Carte Oued Artaibad - Oued Artaibad

Carte Oued Arziz - Oued Arziz

Carte Oued Arzour - Oued Arzour

Carte Oued Ar'arr'ar - Oued Ar'arr'ar Egerger, Oued Ar'arr'ar, Oued Ar’arr’ar

Carte Oued Ar'iden-n-Erar'enine - Oued Ar'iden-n-Erar'enine

Carte Oued Asamisine - Oued Asamisine Oued Asamisine, Ued Asamisin

Carte Oued Aseksem - Oued Aseksem

Carte Oued Asfora - Oued Asfora Oued Asfora, Oued Asfoura, Oued Asfoûra

Carte Oued Askaf - Oued Askaf

Carte Oued Askalou - Oued Askalou

Carte Oued Askef - Oued Askef

Carte Oued Askou - Oued Askou

Carte Oued Aslim Idouguene - Oued Aslim Idouguene

Carte Oued Asouf - Oued Asouf

Carte Oued Asrar - Oued Asrar

Carte Oued Asrhar - Oued Asrhar

Carte Oued Asriouel - Oued Asriouel

Carte Oued Assa - Oued Assa

Carte Oued Assabai - Oued Assabai

Carte Oued Assahor - Oued Assahor

Carte Oued Assassou - Oued Assassou

Carte Oued Asselissane - Oued Asselissane

Carte Oued Assiaf - Oued Assiaf

Carte Oued Assiguedal - Oued Assiguedal

Carte Oued Assouel - Oued Assouel

Carte Oued Assourhmete - Oued Assourhmete

Carte Oued Assout - Oued Assout

Carte Oued Assra - Oued Assra Oued Assra, Oued Assrar

Carte Oued Atata - Oued Atata

Carte Oued Atchane - Oued Atchane Madagre Oued, Oued Atchan, Oued Atchane

Carte Oued Atef Begar - Oued Atef Begar

Carte Oued Ateli - Oued Ateli

Carte Oued Athmane - Oued Athmane

Carte Oued Athmenia - Oued Athmenia

Carte Oued Atia - Oued Atia

Carte Oued Atlaitala - Oued Atlaitala

Carte Oued Attach - Oued Attach Oued Attach, Oued el Atrach

Carte Oued Atteba - Oued Atteba

Carte Oued Azabane - Oued Azabane

Carte Oued Azadjal - Oued Azadjal

Carte Oued Azam - Oued Azam

Carte Oued Azane - Oued Azane

Carte Oued Azaouche - Oued Azaouche

Carte Oued Azebri - Oued Azebri

Carte Oued Azerifaouine - Oued Azerifaouine

Carte Oued Azerou - Oued Azerou

Carte Oued Azerou Mouktar - Oued Azerou Mouktar

Carte Oued Azerzerou - Oued Azerzerou

Carte Oued Azeug - Oued Azeug

Carte Oued Azguiz - Oued Azguiz

Carte Oued Azi - Oued Azi

Carte Oued Aziz - Oued Aziz

Carte Oued Azlaf - Oued Azlaf

Carte Oued Azrou - Oued Azrou

Carte Oued Azzaouia - Oued Azzaouia

Carte Oued Azzouz - Oued Azzouz

Carte Oued A'rfa - Oued A'rfa

Carte Oued Ba Ali - Oued Ba Ali

Carte Oued Baalache - Oued Baalache

Carte Oued Baaroura - Oued Baaroura

Carte Oued Bab - Oued Bab

Carte Oued Bab Khane - Oued Bab Khane

Carte Oued Baba - Oued Baba

Carte Oued Baba Ali - Oued Baba Ali

Carte Oued Badjet el Kbach - Oued Badjet el Kbach

Carte Oued Badoud - Oued Badoud

Carte Oued Baghai - Oued Baghai

Carte Oued Baghdous - Oued Baghdous

Carte Oued Bagrat - Oued Bagrat

Carte Oued Bahari el Kebir - Oued Bahari el Kebir

Carte Oued Bahbah - Oued Bahbah

Carte Oued Bahri - Oued Bahri

Carte Oued Bakedech - Oued Bakedech

Carte Oued Bakhlia - Oued Bakhlia

Carte Oued Balahlalife - Oued Balahlalife

Carte Oued Ballouh - Oued Ballouh

Carte Oued Balloul - Oued Balloul Oued Balloul, Oued Baloul

Carte Oued Ballouta - Oued Ballouta Oued Ballauta, Oued Ballouta, Oued Baloutt, Wadi Ballutah, W?d? Ball??ah

Carte Oued Baoucha - Oued Baoucha

Carte Oued Bar Bou Hadi - Oued Bar Bou Hadi

Carte Oued Barbara - Oued Barbara

Carte Oued Barek - Oued Barek

Carte Oued Bargra - Oued Bargra

Carte Oued Barhoun - Oued Barhoun

Carte Oued Barika - Oued Barika

Carte Oued Barkadjia - Oued Barkadjia Oued Barhadjia, Oued Barkadjia

Carte Oued Barkane - Oued Barkane

Carte Oued Barki - Oued Barki

Carte Oued Barkouka - Oued Barkouka

Carte Oued Baroun - Oued Baroun

Carte Oued Baroune - Oued Baroune

Carte Oued Barour - Oued Barour

Carte Oued Barous - Oued Barous

Carte Oued Barouta - Oued Barouta Oued Barouta, Oued Barrouta

Carte Oued Barrog - Oued Barrog

Carte Oued Batene el Arch - Oued Batene el Arch

Carte Oued Batene el Begra - Oued Batene el Begra

Carte Oued Batiena - Oued Batiena

Carte Oued Bazem - Oued Bazem

Carte Oued Bechahla - Oued Bechahla

Carte Oued Bechar - Oued Bechar

Carte Oued Bechetouane - Oued Bechetouane Oued Bechetouane, Oued Benagat

Carte Oued Bechmed - Oued Bechmed

Carte Oued Bechouch - Oued Bechouch

Carte Oued Bechouk - Oued Bechouk

Carte Oued Beddem - Oued Beddem Oued Beddem, Oued Betrem

Carte Oued Beddiab - Oued Beddiab

Carte Oued Bedioubat - Oued Bedioubat

Carte Oued Bedjaoui - Oued Bedjaoui Oued Bedjaoui, Oued Medjaoui

Carte Oued Bedjeloud - Oued Bedjeloud

Carte Oued Bedjene - Oued Bedjene

Carte Oued Bedzam - Oued Bedzam

Carte Oued Begra - Oued Begra

Carte Oued Beharane - Oued Beharane

Carte Oued Behez - Oued Behez Oued Behez, Oued Behezz

Carte Oued Beida - Oued Beida

Carte Oued Beiter - Oued Beiter

Carte Oued Bejouene el Kerni - Oued Bejouene el Kerni

Carte Oued Bejouene el Mrabta - Oued Bejouene el Mrabta

Carte Oued Bekerdas - Oued Bekerdas

Carte Oued Bekhaita - Oued Bekhaita

Carte Oued Bekkar - Oued Bekkar

Carte Oued Bekkaya - Oued Bekkaya Oued Bekaya, Oued Bekkaya

Carte Oued Bekker - Oued Bekker

Carte Oued Bekkia - Oued Bekkia

Carte Oued Bel Aader - Oued Bel Aader

Carte Oued Bel Abbes - Oued Bel Abbes

Carte Oued Bel Agaig - Oued Bel Agaig

Carte Oued Bel Aoun - Oued Bel Aoun

Carte Oued Bel Archa - Oued Bel Archa

Carte Oued Bel Aroug - Oued Bel Aroug

Carte Oued Bel Azougi - Oued Bel Azougi

Carte Oued Bel Barr - Oued Bel Barr

Carte Oued Bel Bouiguel - Oued Bel Bouiguel

Carte Oued Bel Brahim - Oued Bel Brahim

Carte Oued Bel Chih - Oued Bel Chih

Carte Oued Bel Djerifet - Oued Bel Djerifet

Carte Oued Bel Djouher - Oued Bel Djouher

Carte Oued Bel Fehal - Oued Bel Fehal

Carte Oued Bel Groun - Oued Bel Groun

Carte Oued Bel Ham - Oued Bel Ham

Carte Oued Bel Hared - Oued Bel Hared

Carte Oued Bel Haroug - Oued Bel Haroug

Carte Oued Bel Hassini - Oued Bel Hassini Oued Bel Hassini, Oued Bel Hoccini

Carte Oued Bel Kassem - Oued Bel Kassem Oued Bel Kacem, Oued Bel Kassem

Carte Oued Bel Kebour - Oued Bel Kebour

Carte Oued Bel Khechib - Oued Bel Khechib

Carte Oued Bel Khenafis - Oued Bel Khenafis

Carte Oued Bel Khouchib - Oued Bel Khouchib

Carte Oued Bel Lahcen - Oued Bel Lahcen

Carte Oued Bel Lahmar Bou Rouida - Oued Bel Lahmar Bou Rouida

Carte Oued Bel Lahmar Bou Tkita - Oued Bel Lahmar Bou Tkita

Carte Oued Bel Ouadi - Oued Bel Ouadi

Carte Oued Bel Rmel - Oued Bel Rmel

Carte Oued Bel Rmets - Oued Bel Rmets

Carte Oued Belabyadh - Oued Belabyadh

Carte Oued Belaid - Oued Belaid

Carte Oued Belal - Oued Belal

Carte Oued Belam - Oued Belam

Carte Oued Belaouidet - Oued Belaouidet

Carte Oued Belaouma - Oued Belaouma

Carte Oued Belaroug - Oued Belaroug

Carte Oued Belazhar - Oued Belazhar Oued Belazhar, Oued Bezzeher

Carte Oued Belbane - Oued Belbane

Carte Oued Belel - Oued Belel

Carte Oued Belemtsinine - Oued Belemtsinine

Carte Oued Beleta - Oued Beleta

Carte Oued Belghazi - Oued Belghazi

Carte Oued Belhacine - Oued Belhacine

Carte Oued Belhaoua - Oued Belhaoua

Carte Oued Belhassik - Oued Belhassik

Carte Oued Belhouch - Oued Belhouch

Carte Oued Belhoucine - Oued Belhoucine

Carte Oued Belhouda - Oued Belhouda

Carte Oued Beliata - Oued Beliata

Carte Oued Belilia - Oued Belilia Oued Belilia, Oued Blilia

Carte Oued Belkacem - Oued Belkacem

Carte Oued Belketaief - Oued Belketaief Oued Belguetaief, Oued Belguetaïef, Oued Belketaief, Oued Belketaïef

Carte Oued Belkham - Oued Belkham

Carte Oued Belkharoubi - Oued Belkharoubi

Carte Oued Bellah - Oued Bellah

Carte Oued Bellata - Oued Bellata

Carte Oued Bellil - Oued Bellil

Carte Oued Belourimel - Oued Belourimel

Carte Oued Belrheoua - Oued Belrheoua Oued Belrheoua, Oued Berrhioua

Carte Oued Belrouh - Oued Belrouh

Carte Oued Ben Abbad - Oued Ben Abbad

Carte Oued Ben Abbou - Oued Ben Abbou Oued Ben Abbou, Oued el Abbou

Carte Oued Ben Abide - Oued Ben Abide

Carte Oued Ben Achour - Oued Ben Achour

Carte Oued Ben Adjil - Oued Ben Adjil

Carte Oued Ben Afa - Oued Ben Afa

Carte Oued Ben Ahmed - Oued Ben Ahmed

Carte Oued Ben Aicha - Oued Ben Aicha

Carte Oued Ben Aidi - Oued Ben Aidi

Carte Oued Ben Aissa - Oued Ben Aissa Chaba Ben Aissa, Chaba Ben Aïssa, Oued Ben Aissa, Oued Ben Aïssa

Carte Oued Ben Akrout - Oued Ben Akrout

Carte Oued Ben Alala - Oued Ben Alala

Carte Oued Ben Ali - Oued Ben Ali

Carte Oued Ben Allal - Oued Ben Allal

Carte Oued Ben Allous - Oued Ben Allous

Carte Oued Ben Amra - Oued Ben Amra

Carte Oued Ben Amrane - Oued Ben Amrane

Carte Oued Ben Aouali - Oued Ben Aouali

Carte Oued Ben Aouar - Oued Ben Aouar

Carte Oued Ben Arouba - Oued Ben Arouba

Carte Oued Ben Attach - Oued Ben Attach

Carte Oued Ben Ayed - Oued Ben Ayed Oued Ben Ayad, Oued Ben Ayed

Carte Oued Ben Azba - Oued Ben Azba

Carte Oued Ben Aziz - Oued Ben Aziz

Carte Oued Ben Azouz - Oued Ben Azouz

Carte Oued Ben Azroug - Oued Ben Azroug

Carte Oued Ben Barour - Oued Ben Barour Oued Ben Baroud, Oued Ben Barour

Carte Oued Ben Brika - Oued Ben Brika

Carte Oued Ben Chachia - Oued Ben Chachia

Carte Oued Ben Chahbi - Oued Ben Chahbi

Carte Oued Ben Cheleh - Oued Ben Cheleh

Carte Oued Ben Chetouane - Oued Ben Chetouane

Carte Oued Ben Dafi - Oued Ben Dafi

Carte Oued Ben Daoud - Oued Ben Daoud

Carte Oued ben Daoudeur - Oued ben Daoudeur

Carte Oued Ben Dellah - Oued Ben Dellah

Carte Oued Ben Derma - Oued Ben Derma

Carte Oued Ben Derradj - Oued Ben Derradj

Carte Oued Ben Diab - Oued Ben Diab

Carte Oued Ben Diar - Oued Ben Diar

Carte Oued Ben Dimia - Oued Ben Dimia

Carte Oued Ben Diyab - Oued Ben Diyab Oued Ben Diab, Oued Ben Diyab, Oued Ben Diyâb

Carte Oued Ben Djabeur - Oued Ben Djabeur

Carte Oued Ben Djedid - Oued Ben Djedid

Carte Oued Ben Djelloul - Oued Ben Djelloul

Carte Oued Ben Djmaou - Oued Ben Djmaou Oued Ben Djmaou, Oued Ben Djmâou, Oued Skhouna, Oued Skrouna

Carte Oued Ben Djoreifat - Oued Ben Djoreifat Oued Ben Djereifat, Oued Ben Djoreifat, Oued Ben Djoreïfat, Oued Ben Djorreifat, Oued Ben Djorreïfat, Oued Bou Djorreifat

Carte Oued Ben Dorhmane - Oued Ben Dorhmane

Carte Oued Ben Douli - Oued Ben Douli

Carte Oued Ben ech Chouiref - Oued Ben ech Chouiref

Carte Oued Ben ech Choun - Oued Ben ech Choun

Carte Oued Ben el Hassene - Oued Ben el Hassene Oued Ben Hacene, Oued Ben el Hacen, Oued Ben el Hacene, Oued Ben el Hassene

Carte Oued Ben Fella - Oued Ben Fella Oued Ben Fella, Oued Ben Fellag

Carte Oued Ben Fellah - Oued Ben Fellah

Carte Oued Ben Ghafouz - Oued Ben Ghafouz

Carte Oued Ben Grada - Oued Ben Grada

Carte Oued Ben Guella - Oued Ben Guella

Carte Oued Ben Guerdja - Oued Ben Guerdja

Carte Oued Ben Guerrou - Oued Ben Guerrou

Carte Oued Ben Hamdi - Oued Ben Hamdi

Carte Oued Ben Hamid - Oued Ben Hamid Oued Ben Hamid, Oued Beni Hamid

Carte Oued Ben Hammou - Oued Ben Hammou

Carte Oued Ben Hammouch - Oued Ben Hammouch Oued Ben Hammouch, Oued Bene Hammouche

Carte Oued Ben Hamra - Oued Ben Hamra

Carte Oued Ben Hanni - Oued Ben Hanni

Carte Oued Ben Haoua - Oued Ben Haoua Oued Ben Hadua, Oued Ben Haoua

Carte Oued Ben Hassene - Oued Ben Hassene

Carte Oued Ben Hattab - Oued Ben Hattab

Carte Oued Ben Hazine - Oued Ben Hazine

Carte Oued Ben Hedda - Oued Ben Hedda

Carte Oued Ben Henni - Oued Ben Henni

Carte Oued Ben Kahla - Oued Ben Kahla

Carte Oued Ben Kanou - Oued Ben Kanou

Carte Oued Ben Kechach - Oued Ben Kechach

Carte Oued Ben Khamret - Oued Ben Khamret

Carte Oued Ben Khoris - Oued Ben Khoris Oued Ben Khoris, Oued Ben Khoriss

Carte Oued Ben Khoris el Rharbi - Oued Ben Khoris el Rharbi

Carte Oued Ben Kouria - Oued Ben Kouria

Carte Oued Ben Meddah - Oued Ben Meddah

Carte Oued Ben Melha - Oued Ben Melha

Carte Oued Ben Messaoud - Oued Ben Messaoud

Carte Oued Ben Miloud - Oued Ben Miloud

Carte Oued Ben Moussi - Oued Ben Moussi

Carte Oued Ben Naam - Oued Ben Naam

Carte Oued Ben Nadjar - Oued Ben Nadjar

Carte Oued Ben Namous - Oued Ben Namous

Carte Oued Ben Nasseur - Oued Ben Nasseur

Carte Oued Ben Nirane - Oued Ben Nirane

Carte Oued Ben Nour - Oued Ben Nour

Carte Oued Ben Nsour - Oued Ben Nsour Oued Ben N'Soura, Oued Ben Nsour, Oued Ben N’Soura

Carte Oued Ben Rheris - Oued Ben Rheris

Carte Oued Ben Sabah - Oued Ben Sabah

Carte Oued Ben Sahla - Oued Ben Sahla Oued Ben Sahla, Oued Bent Sahla

Carte Oued Ben Sbaa - Oued Ben Sbaa

Carte Oued Ben Sebti - Oued Ben Sebti

Carte Oued Ben Seline - Oued Ben Seline

Carte Oued Ben Slimane - Oued Ben Slimane

Carte Oued Ben Snoun - Oued Ben Snoun

Carte Oued Ben Sria - Oued Ben Sria Oued Ben Seria, Oued Ben Sria

Carte Oued Ben Teicha - Oued Ben Teicha

Carte Oued Ben Titi - Oued Ben Titi

Carte Oued Ben Yadgh - Oued Ben Yadgh

Carte Oued Ben Yamina - Oued Ben Yamina

Carte Oued Ben Youssef - Oued Ben Youssef Oued Ben Youssef, Oued Ben Yussef

Carte Oued Ben Zahlouf - Oued Ben Zahlouf

Carte Oued Ben Zait - Oued Ben Zait

Carte Oued Ben Zakour - Oued Ben Zakour Oued Ben Zakour, Oued Ben Zekour

Carte Oued Ben Zerhaib - Oued Ben Zerhaib

Carte Oued Ben Zeze - Oued Ben Zeze

Carte Oued Ben Ziane - Oued Ben Ziane

Carte Oued Ben Zineb - Oued Ben Zineb Oued Ben Zineb, Oued Ben Zined

Carte Oued Ben Zireg - Oued Ben Zireg

Carte Oued Ben Zouach - Oued Ben Zouach

Carte Oued Benat es Saiah - Oued Benat es Saiah

Carte Oued Benat Mammar - Oued Benat Mammar

Carte Oued Benchelih - Oued Benchelih

Carte Oued Bene Chibla - Oued Bene Chibla

Carte Oued Bene Djelloul - Oued Bene Djelloul Oued Bene Djelloul, Oued Djelloul

Carte Oued Bene Krelil - Oued Bene Krelil

Carte Oued Benelere - Oued Benelere

Carte Oued Benguemoula - Oued Benguemoula

Carte Oued Beni Atelli - Oued Beni Atelli

Carte Oued Beni Azza - Oued Beni Azza Oued Beni Azi, Oued Beni Azza

Carte Oued Beni Bakhti - Oued Beni Bakhti

Carte Oued Beni Barbar - Oued Beni Barbar

Carte Oued Beni Brahim - Oued Beni Brahim

Carte Oued Beni Dergoun - Oued Beni Dergoun

Carte Oued Beni Filane - Oued Beni Filane

Carte Oued Beni Halem - Oued Beni Halem

Carte Oued Beni Hssen - Oued Beni Hssen

Carte Oued Beni Khalifa - Oued Beni Khalifa

Carte Oued Beni Mellikech - Oued Beni Mellikech Oued Beni Mellikech, Oued Beni Mellikeuch

Carte Oued Beni Mered - Oued Beni Mered Oued Beni Mered, Oued Merad, Oued Mered

Carte Oued Beni Messaoud - Oued Beni Messaoud

Carte Oued Beni Messous - Oued Beni Messous

Carte Oued Beni M'Gatel - Oued Beni M'Gatel Oued Beni M'Gatel, Oued Beni M’Gatel, Oued Megaiet

Carte Oued Beni Okba - Oued Beni Okba Oued Ben Okba, Oued Beni Ogba, Oued Beni Okba

Carte Oued Beni Skajar - Oued Beni Skajar

Carte Oued Beni Smail - Oued Beni Smail

Carte Oued Beni Yahi - Oued Beni Yahi

Carte Oued Beni Zid - Oued Beni Zid Oued Beni Zid, Oued Beni Zîd, Oued Guergoura

Carte Oued Beniane - Oued Beniane Oued Benian, Oued Beniane, Oued Bénian

Carte Oued Bensali - Oued Bensali

Carte Oued Bent el Goumi - Oued Bent el Goumi

Carte Oued Bent el Hassene - Oued Bent el Hassene

Carte Oued Ber Ramad ech Chergui - Oued Ber Ramad ech Chergui

Carte Oued Ber Redjeline - Oued Ber Redjeline

Carte Oued Ber Remad - Oued Ber Remad

Carte Oued Beraber - Oued Beraber

Carte Oued Berada - Oued Berada

Carte Oued Berameth - Oued Berameth

Carte Oued Berber - Oued Berber

Carte Oued Berbeur - Oued Berbeur

Carte Oued Berbour - Oued Berbour Oued Berbour, Oued Berbourg

Carte Oued Berchoum - Oued Berchoum Oued Berchoum, Oued Berhoum

Carte Oued Berda - Oued Berda

Carte Oued Berdid - Oued Berdid

Carte Oued Berdjilat - Oued Berdjilat

Carte Oued Beregoug - Oued Beregoug

Carte Oued Berhoune - Oued Berhoune

Carte Oued Berkai - Oued Berkai

Carte Oued Berkana - Oued Berkana

Carte Oued Berkeche - Oued Berkeche Berkeche, Bèrkèche, Gaston Doumergue, Oued Berkeche, Oued Berkeches

Carte Oued Berkoukch - Oued Berkoukch

Carte Oued Bernous - Oued Bernous

Carte Oued Berouaine - Oued Berouaine

Carte Oued Berrane - Oued Berrane

Carte Oued Berraous - Oued Berraous

Carte Oued Berrekhem - Oued Berrekhem Oued Berrekhem, Oued Berrekrem

Carte Oued Berretail - Oued Berretail

Carte Oued Berretim - Oued Berretim

Carte Oued Berrez - Oued Berrez

Carte Oued Berrezikh - Oued Berrezikh

Carte Oued Berrich - Oued Berrich Oued Barich, Oued Berrich, Oued Berriche, Oued Berriehe

Carte Oued Berriche - Oued Berriche Oued Berrich, Oued Berriche

Carte Oued Berrichet - Oued Berrichet

Carte Oued Berrout - Oued Berrout Oued Berrout, Oued Berroutt

Carte Oued Berzgal - Oued Berzgal Oued Berzgal, Oued Brisgane

Carte Oued Besbassa - Oued Besbassa

Carte Oued Besbassi - Oued Besbassi

Carte Oued Besbes - Oued Besbes

Carte Oued Besbessa - Oued Besbessa

Carte Oued Bessal - Oued Bessal

Carte Oued Bessam - Oued Bessam

Carte Oued Bessibis - Oued Bessibis

Carte Oued Bessrhous - Oued Bessrhous Oued Bessrhous, Oued Bessrhouss

Carte Oued Betka - Oued Betka

Carte Oued Betsabane - Oued Betsabane

Carte Oued Bezaz - Oued Bezaz

Carte Oued Bezeraria - Oued Bezeraria

Carte Oued Bezzerab - Oued Bezzerab

Carte Oued Biar - Oued Biar

Carte Oued Bibi - Oued Bibi

Carte Oued Bichouah - Oued Bichouah

Carte Oued Bidjer - Oued Bidjer

Carte Oued Bidour - Oued Bidour Oued Bidour, Wadi Budur, W?d? Bud?r

Carte Oued Bieta - Oued Bieta

Carte Oued Bine el Amoud - Oued Bine el Amoud

Carte Oued Bine el Djebline - Oued Bine el Djebline

Carte Oued Bir - Oued Bir

Carte Oued Bir Ben Haddouch - Oued Bir Ben Haddouch

Carte Oued Bir Djedida - Oued Bir Djedida Oued Bir Djedida, Oued Bir Jedida

Carte Oued Bir el Ater - Oued Bir el Ater

Carte Oued Biraour - Oued Biraour

Carte Oued Birikad - Oued Birikad Oued Bir Recade, Oued Bir Récade, Oued Birikad, Oued Bîrîkâd

Carte Oued Biskra - Oued Biskra

Carte Oued Bitam - Oued Bitam Oued Bitam, Oued Bitham

Carte Oued Bizbibidj - Oued Bizbibidj

Carte Oued Blatidj - Oued Blatidj

Carte Oued Bokaa - Oued Bokaa

Carte Oued bon Mimoun - Oued bon Mimoun

Carte Oued Bordj el Loul - Oued Bordj el Loul

Carte Oued Bordji - Oued Bordji

Carte Oued Bossoar - Oued Bossoar

Carte Oued Botma es Saiada - Oued Botma es Saiada

Carte Oued Bou Aaroua - Oued Bou Aaroua

Carte Oued Bou Abbou - Oued Bou Abbou

Carte Oued Bou Abeg - Oued Bou Abeg

Carte Oued Bou Achich - Oued Bou Achich

Carte Oued Bou Adjeb - Oued Bou Adjeb

Carte Oued Bou Adjemi - Oued Bou Adjemi

Carte Oued Bou Adouane - Oued Bou Adouane

Carte Oued Bou Ahfouana - Oued Bou Ahfouana

Carte Oued Bou Ahmad - Oued Bou Ahmad

Carte Oued Bou Aidane - Oued Bou Aidane

Carte Oued Bou Aifa - Oued Bou Aifa

Carte Oued Bou Aioun - Oued Bou Aioun

Carte Oued Bou Aissa - Oued Bou Aissa

Carte Oued Bou Aissi - Oued Bou Aissi

Carte Oued Bou Alallah - Oued Bou Alallah

Carte Oued Bou Alam - Oued Bou Alam

Carte Oued Bou Alfrane - Oued Bou Alfrane

Carte Oued Bou Ali - Oued Bou Ali

Carte Oued Bou Allala - Oued Bou Allala

Carte Oued Bou Allouch - Oued Bou Allouch

Carte Oued Bou Amar - Oued Bou Amar Oued Bou Ahmar, Oued Bou Amar, Oued Boû Amar

Carte Oued Bou Amer - Oued Bou Amer

Carte Oued Bou Arbi - Oued Bou Arbi

Carte Oued Bou Aroua - Oued Bou Aroua

Carte Oued Bou Arous - Oued Bou Arous

Carte Oued Bou Atmane - Oued Bou Atmane

Carte Oued Bou Atrous - Oued Bou Atrous Oued Bou Atrous, Oued Bou Atrouss

Carte Oued Bou Aziz - Oued Bou Aziz Chabet Bou 'Aziz, Chabet Bou ’Azîz, Oued Bou Aziz

Carte Oued Bou Azoun - Oued Bou Azoun

Carte Oued Bou Barnas - Oued Bou Barnas

Carte Oued Bou Beida - Oued Bou Beida

Carte Oued Bou Belbal - Oued Bou Belbal

Carte Oued Bou Beyada - Oued Bou Beyada

Carte Oued Bou Caid - Oued Bou Caid

Carte Oued Bou Chachia - Oued Bou Chachia

Carte Oued Bou Chafir - Oued Bou Chafir

Carte Oued Bou Chakour - Oued Bou Chakour

Carte Oued Bou Chekem - Oued Bou Chekem

Carte Oued Bou Chekoua - Oued Bou Chekoua

Carte Oued Bou Chemou - Oued Bou Chemou

Carte Oued Bou Cherb - Oued Bou Cherb

Carte Oued Bou Chitane - Oued Bou Chitane

Carte Oued Bou Chnoun - Oued Bou Chnoun Oued Bou Chenoun, Oued Bou Chnoun, Oued Bou Chnoûn

Carte Oued Bou Chouat - Oued Bou Chouat

Carte Oued Bou Chouk - Oued Bou Chouk

Carte Oued Bou Darhdar - Oued Bou Darhdar

Carte Oued Bou Dekkane - Oued Bou Dekkane

Carte Oued Bou Diss - Oued Bou Diss

Carte Oued Bou Djedaria - Oued Bou Djedaria

Carte Oued Bou Djema - Oued Bou Djema

Carte Oued Bou Djemaa - Oued Bou Djemaa Oued Bou Djemaa, Oued Budjema

Carte Oued Bou Djenaih - Oued Bou Djenaih

Carte Oued Bou Djenane - Oued Bou Djenane

Carte Oued Bou Djerana - Oued Bou Djerana

Carte Oued Bou Djouab - Oued Bou Djouab

Carte Oued Bou Douaou - Oued Bou Douaou

Carte Oued Bou Doukrane - Oued Bou Doukrane Oued Bou Dokhan, Oued Bou Dokrane, Oued Bou Doukrane

Carte Oued Bou Drine - Oued Bou Drine

Carte Oued Bou ed Dardar - Oued Bou ed Dardar

Carte Oued Bou el Achrak - Oued Bou el Achrak

Carte Oued Bou el Ahbeb - Oued Bou el Ahbeb

Carte Oued Bou el Arbaine - Oued Bou el Arbaine

Carte Oued Bou el Bellout - Oued Bou el Bellout

Carte Oued Bou el Hadjar - Oued Bou el Hadjar Oued Bou Hadjar, Oued Bou el Hadjar

Carte Oued Bou el Hajar - Oued Bou el Hajar Oued Bou el Hajar, Oued Haddaratz, Oued el Haddarat, Oued el Haddarât

Carte Oued Bou el Haouich - Oued Bou el Haouich Oued Bou Laouaicha, Oued Bou Laouaïcha, Oued Bou el Haouich

Carte Oued Bou el Hassene - Oued Bou el Hassene Oued Bou el Hasse, Oued Bou el Hassene

Carte Oued Bou el Heraf - Oued Bou el Heraf

Carte Oued Bou el Kardous - Oued Bou el Kardous

Carte Oued Bou el Kherachet - Oued Bou el Kherachet

Carte Oued Bou el Kroud - Oued Bou el Kroud

Carte Oued Bou el Ktem - Oued Bou el Ktem Oued Bou Lektem, Oued Bou el Ktem, Oued Boû el Ktem

Carte Oued Bou en Nebat - Oued Bou en Nebat

Carte Oued Bou er Rega - Oued Bou er Rega

Carte Oued Bou ez Zitouna - Oued Bou ez Zitouna

Carte Oued Bou Fares - Oued Bou Fares

Carte Oued Bou Farhat - Oued Bou Farhat Oued Bou Farhat, Oued Bou Ferhat

Carte Oued Bou Fegous - Oued Bou Fegous

Carte Oued Bou Felad - Oued Bou Felad

Carte Oued Bou Fernan - Oued Bou Fernan

Carte Oued Bou Fessoussa - Oued Bou Fessoussa

Carte Oued Bou Gaa - Oued Bou Gaa

Carte Oued Bou Gaada - Oued Bou Gaada

Carte Oued Bou Gad - Oued Bou Gad

Carte Oued Bou Gatou - Oued Bou Gatou

Carte Oued bou Gattit - Oued bou Gattit

Carte Oued Bou Gdane - Oued Bou Gdane Oued Bou Gdane, Oued Bou Kda, Oued Bou Kdâ

Carte Oued Bou Gdoura - Oued Bou Gdoura Oued Bou Gdoura, Oued Bou Goura, Oued Bou Sdoura, Oued Gdoura, Oued Odoura

Carte Oued Bou Ghalem - Oued Bou Ghalem

Carte Oued Bou Ghalim - Oued Bou Ghalim

Carte Oued Bou Ghebel - Oued Bou Ghebel

Carte Oued Bou Ghrara - Oued Bou Ghrara

Carte Oued Bou Gsaiba - Oued Bou Gsaiba Chaba Bou Ksaiba, Oued Bou Gsaiba, Oued Bou Gsaïba

Carte Oued Bou Guedfine - Oued Bou Guedfine

Carte Oued Bou Guelmamene - Oued Bou Guelmamene

Carte Oued Bou Guelta - Oued Bou Guelta Oued Bou Guelta, Oued Bou Guetat

Carte Oued Bou Guema - Oued Bou Guema

Carte Oued Bou Guerara - Oued Bou Guerara

Carte Oued Bou Guerda - Oued Bou Guerda

Carte Oued Bou Guerdjouma - Oued Bou Guerdjouma

Carte Oued Bou Guetrane - Oued Bou Guetrane

Carte Oued Bou Hacheache - Oued Bou Hacheache

Carte Oued Bou Hachicha - Oued Bou Hachicha

Carte Oued Bou Hadi - Oued Bou Hadi

Carte Oued Bou Hadid - Oued Bou Hadid

Carte Oued Bou Hadjar - Oued Bou Hadjar

Carte Oued Bou Hadjem - Oued Bou Hadjem

Carte Oued Bou Haf - Oued Bou Haf Oued Bou Haf, Oued Bou L'Haf, Oued Bou L’Haf

Carte Oued Bou Hafra - Oued Bou Hafra

Carte Oued Bou Haiane - Oued Bou Haiane

Carte Oued Bou Hamadou - Oued Bou Hamadou

Carte Oued Bou Hamala - Oued Bou Hamala Oued Bou Hamala, Oued Bou Hamela, Oued Bou Hamâla

Carte Oued Bou Hamdane - Oued Bou Hamdane Oued Bou Hamdane, Oued Bou Hamdâne, Oued Guergour

Carte Oued Bou Hamid - Oued Bou Hamid

Carte Oued Bou Hammar - Oued Bou Hammar

Carte Oued Bou Hamouadi - Oued Bou Hamouadi

Carte Oued Bou Hamoud - Oued Bou Hamoud

Carte Oued Bou Hamouda - Oued Bou Hamouda

Carte Oued Bou Haouch Chergui - Oued Bou Haouch Chergui

Carte Oued Bou Haouch Saheli - Oued Bou Haouch Saheli Oued Bou Haouch, Oued Bou Haouch Saheli

Carte Oued Bou Haram - Oued Bou Haram

Carte Oued Bou Hardoun - Oued Bou Hardoun Oued Bou Ardoun, Oued Bou Hardoun, Oued Bou Hardoûn

Carte Oued Bou Harimek - Oued Bou Harimek

Carte Oued Bou Haris - Oued Bou Haris

Carte Oued Bou Hbila - Oued Bou Hbila

Carte Oued Bou Hebila - Oued Bou Hebila

Carte Oued Bou Hennag - Oued Bou Hennag Oued Bou Ennag, Oued Bou Hennag, Oued Boû Hennâg

Carte Oued Bou Herrous - Oued Bou Herrous

Carte Oued Bou Hmama - Oued Bou Hmama

Carte Oued Bou Houa - Oued Bou Houa

Carte Oued Bou Iabes - Oued Bou Iabes Oued Bou Iabes, Oued Bou Yabbess

Carte Oued Bou Iddou - Oued Bou Iddou

Carte Oued Bou Inirhi - Oued Bou Inirhi

Carte Oued Bou Islam - Oued Bou Islam

Carte Oued Bou Isli - Oued Bou Isli

Carte Oued Bou Isouil - Oued Bou Isouil

Carte Oued Bou Issene - Oued Bou Issene

Carte Oued Bou Itane - Oued Bou Itane

Carte Oued Bou Itoumi - Oued Bou Itoumi

Carte Oued Bou Izemarene - Oued Bou Izemarene Oued Bou Izemaren, Oued Bou Izemarene, Oued Bou Izemarèn

Carte Oued Bou Izri - Oued Bou Izri

Carte Oued Bou Kabous - Oued Bou Kabous

Carte Oued Bou Kais - Oued Bou Kais

Carte Oued Bou Kanoun - Oued Bou Kanoun

Carte Oued Bou Kaouar - Oued Bou Kaouar

Carte Oued Bou Karne Lakbache - Oued Bou Karne Lakbache

Carte Oued Bou Karsala - Oued Bou Karsala

Carte Oued Bou Kellouche - Oued Bou Kellouche

Carte Oued Bou Kerachef - Oued Bou Kerachef

Carte Oued Bou Keriba - Oued Bou Keriba

Carte Oued Bou Kermou - Oued Bou Kermou

Carte Oued Bou Kezine - Oued Bou Kezine

Carte Oued Bou Khaled - Oued Bou Khaled

Carte Oued Bou Khandek - Oued Bou Khandek

Carte Oued Bou Khannfous - Oued Bou Khannfous

Carte Oued Bou Khansous - Oued Bou Khansous Oued Bou Khansous, Oued Hammama

Carte Oued Bou Kharouf - Oued Bou Kharouf

Carte Oued Bou Khatem - Oued Bou Khatem

Carte Oued Bou Khechba - Oued Bou Khechba

Carte Oued Bou Khelifa - Oued Bou Khelifa Oued Bou Khelifa, Oued Bou Krelifa

Carte Oued Bou Khellal - Oued Bou Khellal

Carte Oued Bou Khihia - Oued Bou Khihia

Carte Oued Bou Khiza - Oued Bou Khiza Oued Bou Khiza, Oued Bou Kriza

Carte Oued Bou Khlif - Oued Bou Khlif

Carte Oued Bou Khmila - Oued Bou Khmila Oued Bou Khmila, Oued Bou Krmila

Carte Oued Bou Kina - Oued Bou Kina

Carte Oued Bou Kiou - Oued Bou Kiou

Carte Oued Bou Klifa - Oued Bou Klifa

Carte Oued Bou Kmouri - Oued Bou Kmouri

Carte Oued Bou Kourdane - Oued Bou Kourdane

Carte Oued Bou Kralfa - Oued Bou Kralfa

Carte Oued Bou Kra' - Oued Bou Kra' Oued Bou Keraa, Oued Bou Kra', Oued Bou Krah, Oued Boû Krâ’

Carte Oued Bou Ktoum - Oued Bou Ktoum

Carte Oued Bou Laadam - Oued Bou Laadam

Carte Oued Bou Ladjeraf - Oued Bou Ladjeraf

Carte Oued Bou Lahcene - Oued Bou Lahcene

Carte Oued Bou Lakakene - Oued Bou Lakakene

Carte Oued Bou Lakhsam - Oued Bou Lakhsam Oued Bou Akhsam, Oued Bou Aksam, Oued Bou Lakhsam, Oued Bou Lakrsam

Carte Oued Bou Lalla - Oued Bou Lalla

Carte Oued Bou Lansat - Oued Bou Lansat Oued Bou Lannsat, Oued Bou Lansat

Carte Oued Bou Larouah - Oued Bou Larouah

Carte Oued Bou Latan - Oued Bou Latan Oued Bou Latan, Oued Bou Latane, Oued Bou Lathan, Oued Boû Latân

Carte Oued Bou Lazassein - Oued Bou Lazassein

Carte Oued Bou Lazeze - Oued Bou Lazeze

Carte Oued Bou La'ouefi - Oued Bou La'ouefi

Carte Oued Bou Lemzaoud - Oued Bou Lemzaoud

Carte Oued Bou Lerhmane - Oued Bou Lerhmane

Carte Oued Bou Lersas - Oued Bou Lersas

Carte Oued Bou Lhilet - Oued Bou Lhilet

Carte Oued Bou Lila - Oued Bou Lila

Carte Oued Bou Lilef - Oued Bou Lilef

Carte Oued Bou Ljem - Oued Bou Ljem

Carte Oued Bou Maada - Oued Bou Maada

Carte Oued Bou Maaguet - Oued Bou Maaguet

Carte Oued Bou Maane - Oued Bou Maane Oued Bou Maane, Oued Bou Maâne, Oued Bou-Maan, Oued Bou-Maân

Carte Oued Bou Maddour - Oued Bou Maddour

Carte Oued Bou Madjeur - Oued Bou Madjeur Oued Bou Madjer, Oued Bou Madjeur

Carte Oued Bou Maidouna - Oued Bou Maidouna Oued Bou Maidouna, Oued Boumidouna, Oued Boû Maïdoûna

Carte Oued Bou Marirh - Oued Bou Marirh

Carte Oued Bou Marsoum - Oued Bou Marsoum Oued Bou Marsoum, Oued Bou Nasroun

Carte Oued Bou Mausoui - Oued Bou Mausoui

Carte Oued Bou Mehdi - Oued Bou Mehdi

Carte Oued Bou Melil - Oued Bou Melil

Carte Oued Bou Mellas - Oued Bou Mellas

Carte Oued Bou Mellet - Oued Bou Mellet

Carte Oued Bou Merzoug - Oued Bou Merzoug

Carte Oued Bou Meslaha - Oued Bou Meslaha

Carte Oued Bou Messaoud - Oued Bou Messaoud

Carte Oued Bou Messous - Oued Bou Messous Chaba Bou Messous, Oued Bou Messous, Oued Bou Messoûs

Carte Oued Bou Mezoudj - Oued Bou Mezoudj

Carte Oued Bou Mhadjar - Oued Bou Mhadjar

Carte Oued Bou Mia - Oued Bou Mia

Carte Oued Bou Midouna - Oued Bou Midouna

Carte Oued Bou Mlih - Oued Bou Mlih Oued Ben Mlih, Oued Bou Mlih

Carte Oued Bou Mouna - Oued Bou Mouna

Carte Oued Bou Mrah - Oued Bou Mrah

Carte Oued Bou Mrheirfa - Oued Bou Mrheirfa Oued Bou Mgheirfa, Oued Bou Mrheirfa, Oued Bou Mrheïrfa

Carte Oued Bou Nafaa - Oued Bou Nafaa

Carte Oued Bou Nammour - Oued Bou Nammour

Carte Oued Bou Namoussa - Oued Bou Namoussa Oued Bou Namoussa, Oued Namoussa, Wad Bu Namussa, Wad Mafrag

Carte Oued Bou n'Namous - Oued Bou n'Namous

Carte Oued Bou Ohouaya - Oued Bou Ohouaya

Carte Oued Bou Ralia - Oued Bou Ralia

Carte Oued Bou Ranam - Oued Bou Ranam

Carte Oued Bou Raoua - Oued Bou Raoua

Carte Oued Bou Rdine - Oued Bou Rdine Oued Bou Rdine, Oued Bou Rdîne, Oued Bou Redine

Carte Oued Bou Redim - Oued Bou Redim

Carte Oued Bou Redine - Oued Bou Redine

Carte Oued Bou Redoud - Oued Bou Redoud

Carte Oued Bou Rekane - Oued Bou Rekane

Carte Oued Bou Reslane - Oued Bou Reslane

Carte Oued Bou Rhar - Oued Bou Rhar

Carte Oued Bou Rhelal - Oued Bou Rhelal

Carte Oued Bou Rhena - Oued Bou Rhena

Carte Oued Bou Rhoufala - Oued Bou Rhoufala

Carte Oued Bou Riah - Oued Bou Riah

Carte Oued Bou Rih - Oued Bou Rih

Carte Oued Bou Riyah - Oued Bou Riyah

Carte Oued Bou Rkhis - Oued Bou Rkhis

Carte Oued Bou Rkiza - Oued Bou Rkiza

Carte Oued Bou Roumane - Oued Bou Roumane

Carte Oued Bou Roumi - Oued Bou Roumi Oued Bou Roumi, Oued Roumi

Carte Oued Bou R'fiou - Oued Bou R'fiou

Carte Oued Bou Saada - Oued Bou Saada

Carte Oued Bou Saag - Oued Bou Saag

Carte Oued Bou Safoula - Oued Bou Safoula

Carte Oued Bou Said - Oued Bou Said

Carte Oued Bou Salah - Oued Bou Salah

Carte Oued Bou Samghane - Oued Bou Samghane

Carte Oued Bou Sbaa - Oued Bou Sbaa

Carte Oued Bou Seba Louhat - Oued Bou Seba Louhat

Carte Oued Bou Sekhine - Oued Bou Sekhine Oued Bou Sekhine, Oued Bou Sekkine

Carte Oued Bou Sekine - Oued Bou Sekine

Carte Oued Bou Selah - Oued Bou Selah

Carte Oued Bou Sellam - Oued Bou Sellam Oued Bou Sellam, Oued Bou Sellan, Wadi Bou Sellam

Carte Oued Bou Seroual - Oued Bou Seroual

Carte Oued Bou Siaba - Oued Bou Siaba Oued Bou Saba, Oued Bou Siaba, Oued Bou Sieba

Carte Oued Bou Silem - Oued Bou Silem

Carte Oued Bou Skif - Oued Bou Skif Oued Bou Aif, Oued Bou Aïf, Oued Bou Skif

Carte Oued Bou Skoum - Oued Bou Skoum

Carte Oued Bou Slah - Oued Bou Slah

Carte Oued Bou Slama - Oued Bou Slama

Carte Oued Bou Slimane - Oued Bou Slimane

Carte Oued Bou Slit - Oued Bou Slit Oued Bou Selit, Oued Bou Slit

Carte Oued Bou Souf - Oued Bou Souf

Carte Oued Bou Sousna - Oued Bou Sousna

Carte Oued Bou Taane - Oued Bou Taane

Carte Oued Bou Taleb - Oued Bou Taleb Oued Bou Taieb, Oued Bou Taleb, Oued el Taleb

Carte Oued Bou Tammai - Oued Bou Tammai Oued Bou Tammai, Oued Bou Tammart, Oued Bou Tammaï

Carte Oued Bou Tane - Oued Bou Tane

Carte Oued Bou Terkine - Oued Bou Terkine Oued Bou Terkfin, Oued Bou Terkin, Oued Bou Terkine

Carte Oued Bou Tharene - Oued Bou Tharene

Carte Oued Bou Tleth - Oued Bou Tleth

Carte Oued Bou Toui - Oued Bou Toui

Carte Oued Bou Touil - Oued Bou Touil

Carte Oued Bou Touta - Oued Bou Touta

Carte Oued Bou Toutel - Oued Bou Toutel

Carte Oued Bou Trekfine - Oued Bou Trekfine

Carte Oued Bou Yakoub - Oued Bou Yakoub Oued Bou Yacoub, Oued Bou Yakoub, Wad Bu Yacub

Carte Oued Bou Yethma - Oued Bou Yethma

Carte Oued Bou Zana - Oued Bou Zana

Carte Oued bou Zanndai - Oued bou Zanndai

Carte Oued Bou Zardjoune - Oued Bou Zardjoune

Carte Oued Bou Zarhou - Oued Bou Zarhou Oued Bou Zahrou, Oued Bou Zarhou

Carte Oued Bou Zazen - Oued Bou Zazen Oued Bou Zazen, Oued Bou Zazene

Carte Oued Bou Zegza - Oued Bou Zegza

Carte Oued Bou Zelane - Oued Bou Zelane

Carte Oued Bou Zemmour - Oued Bou Zemmour

Carte Oued Bou Zerafa - Oued Bou Zerafa Oued Bou Zerafa, Oued Bou Zerala, Oued Bou Zérala

Carte Oued Bou Zerfa - Oued Bou Zerfa

Carte Oued Bou Zguima - Oued Bou Zguima

Carte Oued Bou Ziad - Oued Bou Ziad

Carte Oued Bou Zoulai - Oued Bou Zoulai

Carte Oued Bou 'Ank - Oued Bou 'Ank

Carte Oued Bouaaouani - Oued Bouaaouani Oued Bouaaouam, Oued Bouaaouani

Carte Oued Bouaba Ben Cheikh - Oued Bouaba Ben Cheikh

Carte Oued Bouadha - Oued Bouadha

Carte Oued Bouadour - Oued Bouadour

Carte Oued Bouahrara - Oued Bouahrara Oued Bou Rara, Oued Bouahrara

Carte Oued Bouamar - Oued Bouamar

Carte Oued Bouchabane - Oued Bouchabane

Carte Oued Bouchama - Oued Bouchama

Carte Oued Bouchane - Oued Bouchane

Carte Oued Bouchebka - Oued Bouchebka

Carte Oued Boucheghal - Oued Boucheghal Oued Bou Cheral, Oued Boucheghal, Oued Boucherat

Carte Oued Bouchek Tarhzaret - Oued Bouchek Tarhzaret

Carte Oued Bouchiba - Oued Bouchiba

Carte Oued Bouchiha - Oued Bouchiha

Carte Oued Bouchitane - Oued Bouchitane

Carte Oued Bouchouk - Oued Bouchouk

Carte Oued Boudahna - Oued Boudahna

Carte Oued Boudbara - Oued Boudbara

Carte Oued Boudensene - Oued Boudensene

Carte Oued Boudhouba - Oued Boudhouba

Carte Oued Boudissa - Oued Boudissa

Carte Oued Boudjamel - Oued Boudjamel

Carte Oued Boudjane - Oued Boudjane

Carte Oued Boudjiber - Oued Boudjiber

Carte Oued Boudjihane - Oued Boudjihane

Carte Oued Boudjra - Oued Boudjra

Carte Oued Boudou - Oued Boudou

Carte Oued Bouelbbene - Oued Bouelbbene

Carte Oued Boufahamet - Oued Boufahamet

Carte Oued Boufane - Oued Boufane Oued Bou Fane, Oued Boufane

Carte Oued Boufarkout - Oued Boufarkout

Carte Oued Boufarroudj - Oued Boufarroudj Oued Bou Ferroudj, Oued Boufarroudj

Carte Oued Boughalesse - Oued Boughalesse

Carte Oued Boughar - Oued Boughar

Carte Oued Bougharda - Oued Bougharda Oued Bougharda, Oued el Marksel

Carte Oued Boughendja - Oued Boughendja

Carte Oued Boughrara - Oued Boughrara

Carte Oued Bougous - Oued Bougous

Carte Oued Bougriba - Oued Bougriba

Carte Oued Bougroun - Oued Bougroun

Carte Oued Bouguendouzene - Oued Bouguendouzene

Carte Oued Bouguerda - Oued Bouguerda

Carte Oued Bougueroudj - Oued Bougueroudj

Carte Oued Bouguettranne - Oued Bouguettranne

Carte Oued Bougzoul - Oued Bougzoul Oued Boughzoul, Oued Bougzoul

Carte Oued Bouhadjla - Oued Bouhadjla

Carte Oued Bouhalleb - Oued Bouhalleb

Carte Oued Bouhalou - Oued Bouhalou Oued Bou Hallou, Oued Bouhalou

Carte Oued Bouhraoua - Oued Bouhraoua

Carte Oued Bouighlalene - Oued Bouighlalene

Carte Oued Bouigla - Oued Bouigla

Carte Oued Bouiret - Oued Bouiret

Carte Oued Boukaala - Oued Boukaala

Carte Oued Boukalli - Oued Boukalli Oued Bou Kalli, Oued Boukalli

Carte Oued Boukallouche - Oued Boukallouche Oued Bekkaloche, Oued Boukallouche

Carte Oued Boukara Ali - Oued Boukara Ali

Carte Oued Boukeddidene - Oued Boukeddidene

Carte Oued Boukellal - Oued Boukellal

Carte Oued Boukharrouba - Oued Boukharrouba

Carte Oued Boukhechba - Oued Boukhechba Oued Bou Khachba, Oued Boukhechba

Carte Oued Boukheddou - Oued Boukheddou

Carte Oued Boukhoudja - Oued Boukhoudja

Carte Oued Boukhres - Oued Boukhres

Carte Oued Boukmouri - Oued Boukmouri

Carte Oued Bouknana - Oued Bouknana

Carte Oued Boukraa - Oued Boukraa

Carte Oued Bouktone - Oued Bouktone Oued Boukton, Oued Bouktone, Oued Bouktoun

Carte Oued Boulaadal - Oued Boulaadal Oued Bou Laadal, Oued Boulaadal, Oued Boulâadal

Carte Oued Boulal - Oued Boulal

Carte Oued Boulalaouane - Oued Boulalaouane

Carte Oued Boulayare - Oued Boulayare

Carte Oued Boulbane - Oued Boulbane

Carte Oued Boulefreis - Oued Boulefreis Oued Bou el Freis, Oued Bou el Freiss, Oued Bou el Freïs, Oued Boulefreis, Oued Boulefreïs

Carte Oued Boulensaf - Oued Boulensaf

Carte Oued Boulerdjem - Oued Boulerdjem

Carte Oued Boulfane - Oued Boulfane Oued Boulefrane, Oued Boulfane, Oued Boulfâne

Carte Oued Boulif - Oued Boulif

Carte Oued Boulila - Oued Boulila

Carte Oued Boulmaia - Oued Boulmaia

Carte Oued Boumerdas - Oued Boumerdas Oued Bou Merclass, Oued Bou Merdes, Oued Boumerdas

Carte Oued Boumerdjel - Oued Boumerdjel

Carte Oued Boumessaoud - Oued Boumessaoud

Carte Oued Boumiya - Oued Boumiya Oued Bou Mia, Oued Boumiya

Carte Oued Boumouda - Oued Boumouda

Carte Oued Boumred - Oued Boumred

Carte Oued Bounhieh - Oued Bounhieh

Carte Oued Bounidhal el K'sab - Oued Bounidhal el K'sab

Carte Oued Bounif - Oued Bounif

Carte Oued Bounkhala - Oued Bounkhala Oued Bou Nakhla, Oued Bou Nakrla, Oued Bounkhala

Carte Oued Bourafed - Oued Bourafed

Carte Oued Bourahla - Oued Bourahla

Carte Oued Bourakia - Oued Bourakia

Carte Oued Bouraoua - Oued Bouraoua

Carte Oued Bourchayad - Oued Bourchayad Oued Bourchaid, Oued Bourchayad

Carte Oued Bourdim - Oued Bourdim Oued Borodim, Oued Bourdim

Carte Oued Bouredine - Oued Bouredine

Carte Oued Bourharit - Oued Bourharit

Carte Oued Bourhdar - Oued Bourhdar

Carte Oued Bourhzel - Oued Bourhzel

Carte Oued Bourkika - Oued Bourkika

Carte Oued Bourkla - Oued Bourkla

Carte Oued Bourmil - Oued Bourmil

Carte Oued Bourouboudj - Oued Bourouboudj

Carte Oued Bourrhida - Oued Bourrhida

Carte Oued Boursek - Oued Boursek

Carte Oued Bourzizene - Oued Bourzizene

Carte Oued Bousag - Oued Bousag

Carte Oued Bousnane - Oued Bousnane

Carte Oued Bousselit - Oued Bousselit

Carte Oued Bousslite - Oued Bousslite Oued Bousselit, Oued Bousslite

Carte Oued Boutane - Oued Boutane

Carte Oued Boutark Matene - Oued Boutark Matene

Carte Oued Bouthida - Oued Bouthida Chaba el Outadda, Oued Bouthida

Carte Oued Boutinzane - Oued Boutinzane Chaba Bou Tennzer, Oued Boutinzane

Carte Oued Boutouab - Oued Boutouab

Carte Oued Boutouane - Oued Boutouane

Carte Oued Boutrik - Oued Boutrik

Carte Oued Bouykafrane - Oued Bouykafrane

Carte Oued Bouyousse - Oued Bouyousse

Carte Oued Bouza - Oued Bouza Oued Bouza, Oued Louza

Carte Oued Bouzaher - Oued Bouzaher Oued Bou Zaher, Oued Bouzaher

Carte Oued Bouzeghrene - Oued Bouzeghrene

Carte Oued Bouzegza - Oued Bouzegza

Carte Oued Bouzemeren - Oued Bouzemeren

Carte Oued Bouzemmour - Oued Bouzemmour Chaba Heddia, Oued Bouzemmour

Carte Oued Bouzerdab - Oued Bouzerdab

Carte Oued Bouziabel - Oued Bouziabel

Carte Oued Bouzid - Oued Bouzid

Carte Oued Bouzina - Oued Bouzina

Carte Oued Brahim - Oued Brahim

Carte Oued Brahimat - Oued Brahimat

Carte Oued Brana - Oued Brana

Carte Oued Branes - Oued Branes

Carte Oued Branis - Oued Branis

Carte Oued Braredj - Oued Braredj

Carte Oued Breala - Oued Breala

Carte Oued Brida - Oued Brida

Carte Oued Bridja - Oued Bridja

Carte Oued Brika - Oued Brika

Carte Oued Bsibissa - Oued Bsibissa Oued Becibissa, Oued Besibissa, Oued Bessibissa, Oued Bsibissa, Oued Bésibissa

Carte Oued Chaab el Hallouf - Oued Chaab el Hallouf

Carte Oued Chaab el Hamra - Oued Chaab el Hamra

Carte Oued Chaab el Klat - Oued Chaab el Klat

Carte Oued Chaabant - Oued Chaabant

Carte Oued Chaamba - Oued Chaamba

Carte Oued Chab el Biya - Oued Chab el Biya

Carte Oued Chaba - Oued Chaba

Carte Oued Chabet ed Dib - Oued Chabet ed Dib

Carte Oued Chabet Grine - Oued Chabet Grine

Carte Oued Chabet Zeboudja - Oued Chabet Zeboudja

Carte Oued Chadli - Oued Chadli

Carte Oued Chaib - Oued Chaib

Carte Oued Chaib Rassa - Oued Chaib Rassa

Carte Oued Chaiba - Oued Chaiba

Carte Oued Chaibet - Oued Chaibet

Carte Oued Chair - Oued Chair

Carte Oued Chakoura - Oued Chakoura

Carte Oued Chalmi - Oued Chalmi

Carte Oued Cham - Oued Cham

Carte Oued Chammam - Oued Chammam Chaba Tekbia el Beya, Oued Chammam

Carte Oued Chanaer - Oued Chanaer

Carte Oued Charchara - Oued Charchara

Carte Oued Charchora - Oued Charchora

Carte Oued Charef - Oued Charef

Carte Oued Charfa - Oued Charfa

Carte Oued Cha'chou - Oued Cha'chou Oued Cha'chou, Oued Cha’choû, Oued Cherchour

Carte Oued Chbela - Oued Chbela

Carte Oued Chebaba - Oued Chebaba

Carte Oued Chebareg - Oued Chebareg

Carte Oued Chebba - Oued Chebba

Carte Oued Chebbi - Oued Chebbi

Carte Oued Chebeane - Oued Chebeane Oued Chebean, Oued Chebeane

Carte Oued Chebil - Oued Chebil

Carte Oued Chebket el Hamra - Oued Chebket el Hamra

Carte Oued Chebouti - Oued Chebouti

Carte Oued Cheddou - Oued Cheddou

Carte Oued Cheffia - Oued Cheffia

Carte Oued Chegga - Oued Chegga

Carte Oued Chegga el Beida - Oued Chegga el Beida Oued Chegg el Beida, Oued Chegg el Beïda, Oued Chegga el Beida, Oued Chegga el Beïda

Carte Oued Cheggat - Oued Cheggat

Carte Oued Cheguieg - Oued Cheguieg

Carte Oued Cheguiga - Oued Cheguiga

Carte Oued Cheham - Oued Cheham Oued Cham, Oued Cheham, Villars

Carte Oued Cheikh - Oued Cheikh Oued Cheikh, Oued Cheïkh, Oued Chikh

Carte Oued Cheikh Ben Amar - Oued Cheikh Ben Amar

Carte Oued Chekkal - Oued Chekkal

Carte Oued Chekko - Oued Chekko

Carte Oued Chekroune - Oued Chekroune

Carte Oued Chelal - Oued Chelal

Carte Oued Chelif - Oued Chelif

Carte Oued Chemeder - Oued Chemeder

Carte Oued Chemloul - Oued Chemloul

Carte Oued Chemora - Oued Chemora

Carte Oued Chenachane - Oued Chenachane Oued Chenachan, Oued Chenachane

Carte Oued Chenchane - Oued Chenchane

Carte Oued Cheniguel - Oued Cheniguel

Carte Oued Chenija - Oued Chenija

Carte Oued Cheniour - Oued Cheniour

Carte Oued Chennaoura - Oued Chennaoura

Carte Oued Cher Chara - Oued Cher Chara

Carte Oued Cheraga - Oued Cheraga

Carte Oued Cheraia - Oued Cheraia

Carte Oued Cherchara - Oued Cherchara

Carte Oued Cherchour - Oued Cherchour

Carte Oued Cherf - Oued Cherf

Carte Oued Chergui - Oued Chergui

Carte Oued Cheria - Oued Cheria

Carte Oued Cherif - Oued Cherif

Carte Oued Cheriha - Oued Cheriha

Carte Oued Cherik - Oued Cherik

Carte Oued Cherrak - Oued Cherrak

Carte Oued Chertiouah - Oued Chertiouah

Carte Oued Chet Iler - Oued Chet Iler Oued Chet Iler, Oued Chet Iter

Carte Oued Chet-Iler - Oued Chet-Iler

Carte Oued Chetite - Oued Chetite Oued Chetite, Oued Tafrennt

Carte Oued Cheurfa - Oued Cheurfa

Carte Oued Chia - Oued Chia

Carte Oued Chiboub - Oued Chiboub

Carte Oued Chieker - Oued Chieker

Carte Oued Chiffa - Oued Chiffa

Carte Oued Chih - Oued Chih

Carte Oued Chiha - Oued Chiha

Carte Oued Chkemia - Oued Chkemia

Carte Oued Chlef - Oued Chlef

Carte Oued Chlih - Oued Chlih

Carte Oued Chnafa - Oued Chnafa

Carte Oued Chorfa - Oued Chorfa Oued Chorfa, Village du Barrage

Carte Oued Chouchane - Oued Chouchane

Carte Oued Choueref - Oued Choueref

Carte Oued Chouikat - Oued Chouikat

Carte Oued Chouiker - Oued Chouiker

Carte Oued Chouk - Oued Chouk

Carte Oued Chouly - Oued Chouly Oued Chouli, Oued Chouly

Carte Oued Chourka - Oued Chourka

Carte Oued Chouyah - Oued Chouyah Oued Chouyah, Oued Chovyah

Carte Oued Chraia - Oued Chraia

Carte Oued Chrih - Oued Chrih

Carte Oued Chtebia - Oued Chtebia Oued Chetibia, Oued Chtebia

Carte Oued Corso - Oued Corso

Carte Oued Daass - Oued Daass

Carte Oued Daba - Oued Daba

Carte Oued Dahmane - Oued Dahmane

Carte Oued Dahmoun - Oued Dahmoun Oued Dahman, Oued Dahmoun

Carte Oued Dahnoun el Betoum - Oued Dahnoun el Betoum

Carte Oued Dahnoun el Mahroug - Oued Dahnoun el Mahroug

Carte Oued Daia - Oued Daia

Carte Oued Daiet ech Chiha - Oued Daiet ech Chiha

Carte Oued Daiet Tati - Oued Daiet Tati

Carte Oued Dakhla - Oued Dakhla

Carte Oued Dalia - Oued Dalia

Carte Oued Damerane - Oued Damerane

Carte Oued Damous - Oued Damous Oued Damous, Oued Ed Damous, Oued Ed Damoûs

Carte Oued Damrane - Oued Damrane

Carte Oued Danoun - Oued Danoun

Carte Oued Daouadri - Oued Daouadri

Carte Oued Daoudar - Oued Daoudar

Carte Oued Daoussa - Oued Daoussa Oued Daoussa, Oued Douassa

Carte Oued Dar Amlel - Oued Dar Amlel

Carte Oued Dar Djab Allah - Oued Dar Djab Allah Oued Dar Djab Allah, Oued Dar Jab Allah

Carte Oued Dar el Beida - Oued Dar el Beida

Carte Oued Dar el Hem - Oued Dar el Hem

Carte Oued Dar el Oued - Oued Dar el Oued

Carte Oued Dar el Outa - Oued Dar el Outa

Carte Oued Dar Ghenem - Oued Dar Ghenem Oued Dar Ghenem, Oued Dar Rhenem

Carte Oued Dar Moussa - Oued Dar Moussa

Carte Oued Dar M'aouiya - Oued Dar M'aouiya

Carte Oued Dara - Oued Dara

Carte Oued Dardar - Oued Dardar

Carte Oued Darek - Oued Darek

Carte Oued Dbous - Oued Dbous

Carte Oued de Emchekel - Oued de Emchekel

Carte Oued Deba - Oued Deba

Carte Oued Debai - Oued Debai

Carte Oued Debboussi - Oued Debboussi

Carte Oued Debdeb - Oued Debdeb

Carte Oued Debdeba - Oued Debdeba

Carte Oued Dechra - Oued Dechra

Carte Oued Defali - Oued Defali

Carte Oued Deffa - Oued Deffa

Carte Oued Defila - Oued Defila

Carte Oued Defilia - Oued Defilia

Carte Oued Defla - Oued Defla

Carte Oued Deflaia - Oued Deflaia

Carte Oued Deghach - Oued Deghach

Carte Oued Degrah - Oued Degrah

Carte Oued Deguensouf - Oued Deguensouf Oued Deguennsouf, Oued Deguensouf

Carte Oued Deguet Fakhi - Oued Deguet Fakhi

Carte Oued Dehaiba - Oued Dehaiba

Carte Oued Dehamecha - Oued Dehamecha

Carte Oued Dehar el Kafer - Oued Dehar el Kafer

Carte Oued Deheb - Oued Deheb

Carte Oued Dehine - Oued Dehine

Carte Oued Deil es Slougui - Oued Deil es Slougui

Carte Oued Dekamene - Oued Dekamene

Carte Oued Dekheila - Oued Dekheila

Carte Oued Dekhi - Oued Dekhi Oued Dekhi, Oued Dekri, Oued de Kri

Carte Oued Dekhla - Oued Dekhla

Carte Oued Dekla el Hamra - Oued Dekla el Hamra Oued Dekhla el Hamra, Oued Dekla el Hamra

Carte Oued Dekma - Oued Dekma

Carte Oued Delensi - Oued Delensi

Carte Oued Delledj - Oued Delledj

Carte Oued Deloutene - Oued Deloutene

Carte Oued Demdoum - Oued Demdoum

Carte Oued Demmed - Oued Demmed

Carte Oued Demrhat ech Chergui - Oued Demrhat ech Chergui

Carte Oued Demrhat el Rharbi - Oued Demrhat el Rharbi

Carte Oued Derbi - Oued Derbi

Carte Oued Derdaza - Oued Derdaza Chaba Derdexa, Chaba Derdéxa, Oued Derdaza

Carte Oued Derder - Oued Derder

Carte Oued Derdez - Oued Derdez

Carte Oued Derdousse - Oued Derdousse

Carte Oued Derhara - Oued Derhara

Carte Oued Derhima - Oued Derhima

Carte Oued Derib - Oued Derib

Carte Oued Deries - Oued Deries

Carte Oued Dermoun - Oued Dermoun

Carte Oued Deroua - Oued Deroua

Carte Oued Derrouine - Oued Derrouine

Carte Oued Deurdeur - Oued Deurdeur Oued Derder, Oued Deurdeur

Carte Oued Dez - Oued Dez

Carte Oued Dezair - Oued Dezair

Carte Oued Dezzeh - Oued Dezzeh

Carte Oued Dgaga - Oued Dgaga

Carte Oued Dhaia - Oued Dhaia

Carte Oued Dhoukkara - Oued Dhoukkara

Carte Oued Di Amza Atine - Oued Di Amza Atine

Carte Oued di Beni Mdas - Oued di Beni Mdas

Carte Oued di Bou Dardar - Oued di Bou Dardar Oued Bou ed Dardar, Oued Boû ed Dardâr, Oued di Bou Dardar

Carte Oued di Bou Rihane - Oued di Bou Rihane

Carte Oued di Bou Touga - Oued di Bou Touga

Carte Oued di Djebel - Oued di Djebel Oued Li Ledjbel, Oued di Djebel

Carte Oued Di el Ahrach - Oued Di el Ahrach

Carte Oued Di el Bared - Oued Di el Bared

Carte Oued di el Fercha - Oued di el Fercha

Carte Oued Di el Fhissa - Oued Di el Fhissa

Carte Oued Di el Habal - Oued Di el Habal Oued Bin el Ouiden, Oued Di el Habal, Oued Dî el Habâl

Carte Oued di el M'Kala - Oued di el M'Kala

Carte Oued Di es Sedjane - Oued Di es Sedjane Oued Di es Sedjane, Oued Dî es Sedjane, Oued Souk

Carte Oued Di et Teroua - Oued Di et Teroua

Carte Oued di Grandafal - Oued di Grandafal

Carte Oued di Medjana - Oued di Medjana

Carte Oued di Merdj el Kheil - Oued di Merdj el Kheil

Carte Oued di Mouehene - Oued di Mouehene

Carte Oued di Ouled Zaid - Oued di Ouled Zaid

Carte Oued Diar el Maiz - Oued Diar el Maiz

Carte Oued Diar Louba - Oued Diar Louba

Carte Oued Diba - Oued Diba

Carte Oued Dider - Oued Dider

Carte Oued Diedaft - Oued Diedaft

Carte Oued Difel - Oued Difel

Carte Oued Dilamess - Oued Dilamess

Carte Oued Dilia - Oued Dilia

Carte Oued Dimene - Oued Dimene

Carte Oued Dir - Oued Dir

Carte Oued Dir el Abiod - Oued Dir el Abiod

Carte Oued Direg - Oued Direg

Carte Oued Diroug - Oued Diroug Oued Diroug

Carte Oued Dis - Oued Dis

Carte Oued Diss - Oued Diss

Carte Oued Djadja - Oued Djadja

Carte Oued Djafou - Oued Djafou Jafu, Oued Djafou

Carte Oued Djahfa - Oued Djahfa

Carte Oued Djahmine - Oued Djahmine

Carte Oued Djama - Oued Djama Oued Djama, Oued Djemaa, Oued Djemma

Carte Oued Djanti - Oued Djanti

Carte Oued Djaou - Oued Djaou

Carte Oued Djaou Djellel - Oued Djaou Djellel

Carte Oued Djarchdel - Oued Djarchdel

Carte Oued Djaret - Oued Djaret Oued Djaret, Oued Jaret

Carte Oued Djarfi - Oued Djarfi

Carte Oued Djarrar - Oued Djarrar

Carte Oued Djeaddir - Oued Djeaddir

Carte Oued Djebailia - Oued Djebailia

Carte Oued Djeballah Ben Aierh - Oued Djeballah Ben Aierh

Carte Oued Djebbas - Oued Djebbas

Carte Oued Djebil - Oued Djebil Oued Djebil, Oued Jebil

Carte Oued Djebira - Oued Djebira

Carte Oued Djeboub - Oued Djeboub

Carte Oued Djebria - Oued Djebria

Carte Oued Djedaa - Oued Djedaa

Carte Oued Djedari - Oued Djedari

Carte Oued Djedda - Oued Djedda

Carte Oued Djeder - Oued Djeder

Carte Oued Djedi - Oued Djedi

Carte Oued Djedi Ben Ameur - Oued Djedi Ben Ameur

Carte Oued Djedi Mohammed - Oued Djedi Mohammed

Carte Oued Djedid - Oued Djedid

Carte Oued Djedida - Oued Djedida

Carte Oued Djediouia - Oued Djediouia Oued Djediouia, Oued Djidiouia

Carte Oued Djedra - Oued Djedra

Carte Oued Djefadjef - Oued Djefadjef Oued Djefadjef, Oued Jefajef

Carte Oued Djeguega - Oued Djeguega

Carte Oued Djehat - Oued Djehat

Carte Oued Djelbana - Oued Djelbana

Carte Oued Djeld er Rouga - Oued Djeld er Rouga

Carte Oued Djelf Ben Akhal - Oued Djelf Ben Akhal

Carte Oued Djelfa - Oued Djelfa

Carte Oued Djeliba - Oued Djeliba

Carte Oued Djelida - Oued Djelida Oued Djelida, Oued Djellida

Carte Oued Djellakh - Oued Djellakh

Carte Oued Djellal - Oued Djellal

Carte Oued Djellib - Oued Djellib

Carte Oued Djellida - Oued Djellida

Carte Oued Djelloul - Oued Djelloul

Carte Oued Djelouata - Oued Djelouata

Carte Oued Djemaa - Oued Djemaa Commune d' Oued el Djemaa, Commune d’ Oued el Djemaa, Oued Djemaa

Carte Oued Djemba - Oued Djemba

Carte Oued Djembia - Oued Djembia Oued Djembia, Oued Jembia

Carte Oued Djemel - Oued Djemel

Carte Oued Djemila - Oued Djemila

Carte Oued Djemli - Oued Djemli

Carte Oued Djemmorah - Oued Djemmorah Oued Djemmorah, Oued Djemora, Oued Djemorah

Carte Oued Djemri - Oued Djemri

Carte Oued Djenaib - Oued Djenaib

Carte Oued Djenaiene - Oued Djenaiene

Carte Oued Djenane - Oued Djenane

Carte Oued Djenani - Oued Djenani

Carte Oued Djendjene - Oued Djendjene Oued Djendjen, Oued Djendjene, Oued Djenndjene, Oued Djinedjen, Oued Djinedjene

Carte Oued Djenibia - Oued Djenibia

Carte Oued Djeniene el Arich - Oued Djeniene el Arich

Carte Oued Djeninat - Oued Djeninat

Carte Oued Djeniral - Oued Djeniral

Carte Oued Djenirat - Oued Djenirat

Carte Oued Djennane el Baikk - Oued Djennane el Baikk

Carte Oued Djerad - Oued Djerad Oued Djerad, Oued Jrad

Carte Oued Djeraf - Oued Djeraf Oued Djeraf, Oued el Djeraf

Carte Oued Djerai - Oued Djerai

Carte Oued Djerane - Oued Djerane

Carte Oued Djerch - Oued Djerch Oued Djerch, Oued Djerod

Carte Oued Djerdania - Oued Djerdania

Carte Oued Djerdjir - Oued Djerdjir Oued Djerdjir, Oued In Defar

Carte Oued Djeref - Oued Djeref

Carte Oued Djerf el Ahmar - Oued Djerf el Ahmar

Carte Oued Djerf el Azreg - Oued Djerf el Azreg

Carte Oued Djerf et Tir - Oued Djerf et Tir

Carte Oued Djerf et Trab - Oued Djerf et Trab

Carte Oued Djeriat - Oued Djeriat

Carte Oued Djerida - Oued Djerida

Carte Oued Djerif - Oued Djerif

Carte Oued Djeriffat - Oued Djeriffat

Carte Oued Djerimine - Oued Djerimine

Carte Oued Djermane - Oued Djermane

Carte Oued Djermia - Oued Djermia Oued Djermia, Oued Djermina

Carte Oued Djerr - Oued Djerr Oued Djer, Oued Djerr

Carte Oued Djerrada - Oued Djerrada Oued Djerada, Oued Djerrada

Carte Oued Djerrat Aiouaz - Oued Djerrat Aiouaz

Carte Oued Djerziba - Oued Djerziba

Carte Oued Djif Amane - Oued Djif Amane

Carte Oued Djihani - Oued Djihani Oued Djihani, Oued Jihani

Carte Oued Djilali - Oued Djilali Oued Djilali, Oued ed Djilah

Carte Oued Djiouene - Oued Djiouene

Carte Oued Djokhane - Oued Djokhane

Carte Oued Djorf Djada - Oued Djorf Djada

Carte Oued Djorf el Rhorab - Oued Djorf el Rhorab

Carte Oued Djorf Laagab - Oued Djorf Laagab

Carte Oued Djorf Mouka - Oued Djorf Mouka

Carte Oued Djoua - Oued Djoua

Carte Oued Djouf - Oued Djouf

Carte Oued Djouima - Oued Djouima

Carte Oued Djrhirine - Oued Djrhirine

Carte Oued Djrou - Oued Djrou

Carte Oued Dokhane - Oued Dokhane

Carte Oued Doucen - Oued Doucen

Carte Oued Doues - Oued Doues

Carte Oued Doufana - Oued Doufana

Carte Oued Doui - Oued Doui

Carte Oued Douifa - Oued Douifa

Carte Oued Douiouira - Oued Douiouira

Carte Oued Douis el Atchane - Oued Douis el Atchane

Carte Oued Douiyet el Ma - Oued Douiyet el Ma Oued Douiet el Ma, Oued Douiyet el Ma, Oued Douïet el Ma

Carte Oued Doukam - Oued Doukam

Carte Oued Doulani - Oued Doulani

Carte Oued Douma Kbaibia - Oued Douma Kbaibia

Carte Oued Dra en Naga - Oued Dra en Naga

Carte Oued Draa Aklil - Oued Draa Aklil

Carte Oued Draa el Merga - Oued Draa el Merga

Carte Oued Draa Ou Fenas - Oued Draa Ou Fenas Oued Draa Fenas, Oued Draa Ou Fenas, Oued Drâa Ou Fenas

Carte Oued Dradir - Oued Dradir

Carte Oued Dramnia - Oued Dramnia

Carte Oued Dreah - Oued Dreah

Carte Oued Drimil - Oued Drimil

Carte Oued Drina - Oued Drina

Carte Oued Drinn - Oued Drinn

Carte Oued Dsarbia - Oued Dsarbia

Carte Oued Dzouihba - Oued Dzouihba

Carte Oued Ebda - Oued Ebda

Carte Oued Ebora - Oued Ebora

Carte Oued ech Chaba el Beida - Oued ech Chaba el Beida

Carte Oued ech Chaham - Oued ech Chaham

Carte Oued ech Chair - Oued ech Chair

Carte Oued ech Chareuf - Oued ech Chareuf

Carte Oued ech Chebbaba - Oued ech Chebbaba

Carte Oued ech Chebika - Oued ech Chebika

Carte Oued ech Chech - Oued ech Chech

Carte Oued ech Chegga - Oued ech Chegga

Carte Oued ech Cheguig - Oued ech Cheguig

Carte Oued ech Cheikh - Oued ech Cheikh

Carte Oued ech Chemara - Oued ech Chemara

Carte Oued ech Cherfa - Oued ech Cherfa

Carte Oued ech Chergui - Oued ech Chergui

Carte Oued ech Cherka - Oued ech Cherka

Carte Oued ech Chih - Oued ech Chih

Carte Oued ech Chioukh - Oued ech Chioukh Oued ech Chioukh, Oued ech Chioukr

Carte Oued ech Choufa - Oued ech Choufa

Carte Oued ech Ch'ab - Oued ech Ch'ab

Carte Oued Echaaouati - Oued Echaaouati

Carte Oued Eched - Oued Eched

Carte Oued Echegga - Oued Echegga

Carte Oued ed Daa - Oued ed Daa

Carte Oued ed Dab - Oued ed Dab

Carte Oued ed Daffau - Oued ed Daffau

Carte Oued ed Dahimine - Oued ed Dahimine

Carte Oued ed Dahlia - Oued ed Dahlia

Carte Oued ed Dakhla - Oued ed Dakhla

Carte Oued ed Dakrla - Oued ed Dakrla

Carte Oued ed Dal - Oued ed Dal

Carte Oued ed Dalia - Oued ed Dalia

Carte Oued ed Damous - Oued ed Damous

Carte Oued ed Damrane - Oued ed Damrane

Carte Oued ed Daoura - Oued ed Daoura

Carte Oued ed Dardar - Oued ed Dardar

Carte Oued ed Dbiz - Oued ed Dbiz Oued ed Dbiz, Oued ed Dis, Oued ed Diss

Carte Oued ed Deba - Oued ed Deba

Carte Oued ed Debane - Oued ed Debane

Carte Oued ed Debbane - Oued ed Debbane

Carte Oued ed Dechi - Oued ed Dechi

Carte Oued ed Dechra - Oued ed Dechra Oued Msara, Oued Msarâ, Oued ed Dechra

Carte Oued ed Defla - Oued ed Defla

Carte Oued ed Dehalbia - Oued ed Dehalbia

Carte Oued ed Dehessi - Oued ed Dehessi Oued ed Deheci, Oued ed Dehessi

Carte Oued ed Delim - Oued ed Delim

Carte Oued ed Deraouich - Oued ed Deraouich

Carte Oued ed Derou - Oued ed Derou

Carte Oued ed Diab - Oued ed Diab

Carte Oued ed Dib - Oued ed Dib Chabet ed Dib, Oued ed Dib

Carte Oued ed Diba - Oued ed Diba

Carte Oued ed Dir - Oued ed Dir Oued ed Dir, Wadi ad Dayr, W?d? ad Dayr

Carte Oued ed Dis - Oued ed Dis

Carte Oued ed Diss - Oued ed Diss

Carte Oued ed Dissia Noufida - Oued ed Dissia Noufida

Carte Oued Ed Djenane - Oued Ed Djenane

Carte Oued ed Djir - Oued ed Djir

Carte Oued ed Djouf - Oued ed Djouf

Carte Oued ed Dokkara - Oued ed Dokkara

Carte Oued ed Doua - Oued ed Doua Oued ed Doua, Oued el Boua

Carte Oued ed Douiba - Oued ed Douiba

Carte Oued ed Douira - Oued ed Douira Oued Douera, Oued ed Douira

Carte Oued ed Douis - Oued ed Douis

Carte Oued ed Dous - Oued ed Dous Oued Sahel, Oued ed Dous

Carte Oued ed Draa Hansi - Oued ed Draa Hansi Oued ed Draa Hannsi, Oued ed Draa Hansi

Carte Oued Eddeba - Oued Eddeba

Carte Oued Eddib - Oued Eddib Emm, Oued Eddib

Carte Oued Edhorbane - Oued Edhorbane

Carte Oued Edjedal - Oued Edjedal

Carte Oued Edjeladjadje - Oued Edjeladjadje

Carte Oued Edjeriou - Oued Edjeriou

Carte Oued Efatess - Oued Efatess

Carte Oued Efedil - Oued Efedil

Carte Oued Efei - Oued Efei

Carte Oued Eferzi - Oued Eferzi

Carte Oued Effeg - Oued Effeg

Carte Oued Effendi - Oued Effendi Oued Efadek, Oued Effendi

Carte Oued Egegaga - Oued Egegaga

Carte Oued Eghlel - Oued Eghlel

Carte Oued Eguiornenhel - Oued Eguiornenhel

Carte Oued Ehane - Oued Ehane

Carte Oued Ehoudj - Oued Ehoudj

Carte Oued Ekouazet - Oued Ekouazet

Carte Oued el Aaihar - Oued el Aaihar

Carte Oued el Aalouaz - Oued el Aalouaz

Carte Oued el Aaoussedj - Oued el Aaoussedj

Carte Oued el Aar - Oued el Aar

Carte Oued el Abadnia - Oued el Abadnia

Carte Oued el Abbad - Oued el Abbad

Carte Oued el Abd - Oued el Abd

Carte Oued el Abdia - Oued el Abdia

Carte Oued el Abed - Oued el Abed

Carte Oued el Aberri - Oued el Aberri

Carte Oued el Abga - Oued el Abga

Carte Oued el Abid - Oued el Abid

Carte Oued el Abiod - Oued el Abiod

Carte Oued el Abiodh - Oued el Abiodh

Carte Oued el Aboulba - Oued el Aboulba

Carte Oued el Abtal - Oued el Abtal Oued el Abtal, Torki-le-Djuk, Uzes-le-Duc, Uzes-le-Due, Uzès-le-Duc, Uzès-le-Due, ?????-??-???

Carte Oued el Abteur Chergui - Oued el Abteur Chergui

Carte Oued el Abteur Oustani - Oued el Abteur Oustani Oued el Abteur Oustani, Oued el Oustani

Carte Oued el Abteur Rharbi - Oued el Abteur Rharbi

Carte Oued el Acha - Oued el Acha

Carte Oued el Achach - Oued el Achach

Carte Oued el Achana - Oued el Achana

Carte Oued el Acheuch - Oued el Acheuch Oued el Achach, Oued el Acheuch

Carte Oued el Achour - Oued el Achour

Carte Oued el Adaida - Oued el Adaida Oued el Adaida, Oued el Adaïda, Oued el Addaida, Oued el Addaïda

Carte Oued el Adjed - Oued el Adjed Oued Adjeda, Oued el Adjed

Carte Oued el Adjedar - Oued el Adjedar

Carte Oued el Adjeri - Oued el Adjeri Oued el Adieri, Oued el Adjeri

Carte Oued el Adjla - Oued el Adjla

Carte Oued el Adjoul - Oued el Adjoul

Carte Oued el Adjrem - Oued el Adjrem

Carte Oued el Adrek - Oued el Adrek

Carte Oued el Afia - Oued el Afia

Carte Oued el Afin - Oued el Afin

Carte Oued el Agaue - Oued el Agaue Oued el Agaue, Oued el Arss

Carte Oued el Agchioua - Oued el Agchioua

Carte Oued el Aggoun - Oued el Aggoun

Carte Oued el Agou el Hamra - Oued el Agou el Hamra

Carte Oued el Ahmar - Oued el Ahmar

Carte Oued el Ahmara - Oued el Ahmara

Carte Oued el Ahrach - Oued el Ahrach

Carte Oued el Aiane - Oued el Aiane

Carte Oued el Aiguef - Oued el Aiguef

Carte Oued el Aimane - Oued el Aimane

Carte Oued el Aimer - Oued el Aimer

Carte Oued el Ain - Oued el Ain

Carte Oued el Aioun - Oued el Aioun

Carte Oued el Akba - Oued el Akba

Carte Oued el Akhal - Oued el Akhal

Carte Oued el Akra - Oued el Akra

Carte Oued el Alam - Oued el Alam

Carte Oued el Aleg - Oued el Aleg Oued el Aleg

Carte Oued el Alenda - Oued el Alenda

Carte Oued el Alennda - Oued el Alennda El Alennda, Oued el Alennda

Carte Oued el Allal - Oued el Allal

Carte Oued el Alleg - Oued el Alleg

Carte Oued el Allem - Oued el Allem

Carte Oued el Alleug - Oued el Alleug Oued Alleug, Oued el Alleng, Oued el Alleug

Carte Oued el Allouch - Oued el Allouch

Carte Oued el Alta - Oued el Alta

Carte Oued el Amer - Oued el Amer

Carte Oued el Ammamra - Oued el Ammamra

Carte Oued el Ammaria - Oued el Ammaria

Carte Oued el Amouli - Oued el Amouli

Carte Oued el Amri - Oued el Amri

Carte Oued el Amrouz - Oued el Amrouz

Carte Oued el Anasseur - Oued el Anasseur

Carte Oued el Ancor - Oued el Ancor

Carte Oued el Aneb - Oued el Aneb Oued el Aneb, Qued el Aneb

Carte Oued el Anig - Oued el Anig

Carte Oued el Annba - Oued el Annba

Carte Oued el Anng - Oued el Anng

Carte Oued el Anngar - Oued el Anngar Angar Oued el, Oued el Anngar

Carte Oued el Annka - Oued el Annka

Carte Oued el Annseur - Oued el Annseur

Carte Oued el Annza - Oued el Annza

Carte Oued el Anser - Oued el Anser

Carte Oued el Anseur - Oued el Anseur Oued el Annseur, Oued el Anseur

Carte Oued el Aouaria - Oued el Aouaria

Carte Oued el Aoudja - Oued el Aoudja

Carte Oued el Aouedj - Oued el Aouedj

Carte Oued el Aouidj - Oued el Aouidj Oued el Aouidj, Oued el Aouidja

Carte Oued el Aouidja - Oued el Aouidja

Carte Oued el Aouissia - Oued el Aouissia

Carte Oued el Aouna - Oued el Aouna

Carte Oued el Aounia - Oued el Aounia

Carte Oued el Aourati - Oued el Aourati

Carte Oued el Arab - Oued el Arab Oued el Arab, Wadi el Arab

Carte Oued el Aradj - Oued el Aradj

Carte Oued el Araira - Oued el Araira

Carte Oued el Arajam - Oued el Arajam

Carte Oued el Arar - Oued el Arar

Carte Oued el Arara - Oued el Arara

Carte Oued el Arba - Oued el Arba

Carte Oued el Arch - Oued el Arch Oued el Akhch, Oued el Arch

Carte Oued el Archa - Oued el Archa

Carte Oued el Ardjem - Oued el Ardjem Oued el Ardjem, Oued el Lardjem

Carte Oued el Ardjoun - Oued el Ardjoun

Carte Oued el Ared - Oued el Ared

Carte Oued el Arefdji - Oued el Arefdji Oued el Arefdji, Oued el Arefji

Carte Oued el Areit - Oued el Areit

Carte Oued el Ares - Oued el Ares Oued el Ares, Oued el Aress

Carte Oued el Arfedji - Oued el Arfedji

Carte Oued el Aria - Oued el Aria

Carte Oued el Arich - Oued el Arich

Carte Oued el Arich el Meha - Oued el Arich el Meha

Carte Oued el Aricha - Oued el Aricha

Carte Oued el Arid - Oued el Arid Oued el Arid, Oued el Arrid

Carte Oued el Arkoub - Oued el Arkoub

Carte Oued el Arnegue - Oued el Arnegue

Carte Oued el Aroussine - Oued el Aroussine

Carte Oued el Aroya - Oued el Aroya

Carte Oued el Ars - Oued el Ars Oued Aris, Oued el Ars

Carte Oued el Arsatt - Oued el Arsatt

Carte Oued el Asfour - Oued el Asfour

Carte Oued el Askef - Oued el Askef

Carte Oued el Asker - Oued el Asker

Carte Oued el Assel - Oued el Assel

Carte Oued el Ataf - Oued el Ataf

Carte Oued el Atait - Oued el Atait

Carte Oued el Atassa - Oued el Atassa Oued el Atassa, Oued el Attassa

Carte Oued el Atba - Oued el Atba

Carte Oued el Atchane - Oued el Atchane

Carte Oued el Atech - Oued el Atech

Carte Oued el Ateuch - Oued el Ateuch

Carte Oued el Atia - Oued el Atia

Carte Oued el Atik - Oued el Atik

Carte Oued el Atrach - Oued el Atrach

Carte Oued el Atrech - Oued el Atrech

Carte Oued el Atrous - Oued el Atrous

Carte Oued el Attar - Oued el Attar Oued el Atar, Oued el Attar, Wadi el Attar

Carte Oued el Azais - Oued el Azais

Carte Oued el Azeb - Oued el Azeb Oued el Axeb, Oued el Azeb

Carte Oued el Azib - Oued el Azib

Carte Oued el Azreg - Oued el Azreg

Carte Oued el Azzela - Oued el Azzela

Carte Oued el A'Kak - Oued el A'Kak

Carte Oued el Ba - Oued el Ba

Carte Oued el Badja - Oued el Badja

Carte Oued el Baghla - Oued el Baghla Oued el Baghla, Oued el Beghla, Oued el Berhla

Carte Oued el Bagra - Oued el Bagra Oued el Bagra, Oued el Begra

Carte Oued el Baguel - Oued el Baguel

Carte Oued el Bahadi - Oued el Bahadi

Carte Oued el Bahair - Oued el Bahair

Carte Oued el Bahar - Oued el Bahar

Carte Oued el Bahloul - Oued el Bahloul

Carte Oued el Bahm - Oued el Bahm

Carte Oued el Bahri - Oued el Bahri

Carte Oued el Baiad - Oued el Baiad

Carte Oued el Baier - Oued el Baier Oued el Baier, Oued el Baïer, Sehb el Baier, Sehb el Baïer

Carte Oued el Baim - Oued el Baim

Carte Oued el Bair - Oued el Bair

Carte Oued el Bakhi - Oued el Bakhi

Carte Oued el Baloul - Oued el Baloul

Carte Oued el Bane - Oued el Bane

Carte Oued el Bardji - Oued el Bardji

Carte Oued el Barmits - Oued el Barmits

Carte Oued el Barouag - Oued el Barouag Oued Haci el Berouag, Oued el Barouag

Carte Oued el Bateun - Oued el Bateun

Carte Oued el Batoche - Oued el Batoche

Carte Oued el Bedareg - Oued el Bedareg

Carte Oued el Begar - Oued el Begar

Carte Oued el Begrat - Oued el Begrat Oued Begrats, Oued Bel Reghats, Oued Bil Braguetz, Oued el Begrat, Oued el Begrats

Carte Oued el Behair - Oued el Behair

Carte Oued el Behar - Oued el Behar

Carte Oued el Beiad - Oued el Beiad

Carte Oued el Beida - Oued el Beida

Carte Oued el Beiod - Oued el Beiod

Carte Oued el Beiter - Oued el Beiter

Carte Oued el Bekkouch - Oued el Bekkouch Oued el Bekkouch, Oued el Bekkoûch

Carte Oued el Bel - Oued el Bel

Carte Oued el Bel Aksa - Oued el Bel Aksa

Carte Oued el Bel el Rharbi - Oued el Bel el Rharbi

Carte Oued el Belbald - Oued el Belbald

Carte Oued el Bell - Oued el Bell

Carte Oued el Benia - Oued el Benia

Carte Oued el Berarit - Oued el Berarit

Carte Oued el Berbaga - Oued el Berbaga

Carte Oued el Berd - Oued el Berd

Carte Oued el Berda - Oued el Berda

Carte Oued el Berdia - Oued el Berdia

Carte Oued el Berdil - Oued el Berdil

Carte Oued el Berghouth - Oued el Berghouth

Carte Oued el Berhel - Oued el Berhel

Carte Oued el Berich - Oued el Berich

Carte Oued el Beridja - Oued el Beridja Faid Enjer, Faïd Enjer, Oued el Beridja

Carte Oued el Berr - Oued el Berr

Carte Oued el Berraniss - Oued el Berraniss

Carte Oued el Berreg - Oued el Berreg

Carte Oued el Besbas - Oued el Besbas Oued Besbess, Oued el Besbas, Oued el Besbass

Carte Oued el Besbassa - Oued el Besbassa

Carte Oued el Besbassi - Oued el Besbassi Oued Besbassi, Oued el Besbassi

Carte Oued el Besbes - Oued el Besbes Oued el Besbes, Oued el Besbês, Oued es Sebbah

Carte Oued el Bessal - Oued el Bessal

Carte Oued el Betaa - Oued el Betaa

Carte Oued el Beteima - Oued el Beteima

Carte Oued el Bethana - Oued el Bethana Oued Bethane, Oued el Bethana

Carte Oued el Betmaya - Oued el Betmaya

Carte Oued el Betoum - Oued el Betoum Oued Betom, Oued el Betoum

Carte Oued el Betsaa - Oued el Betsaa

Carte Oued el Bhekrit - Oued el Bhekrit

Carte Oued el Biar - Oued el Biar

Carte Oued el Bidane - Oued el Bidane

Carte Oued el Bir - Oued el Bir

Carte Oued el Biraz - Oued el Biraz

Carte Oued el Biya - Oued el Biya Chaba el Lebia, Oued el Biya

Carte Oued el Bodi - Oued el Bodi

Carte Oued el Botha - Oued el Botha

Carte Oued el Botma - Oued el Botma

Carte Oued el Botmaia - Oued el Botmaia

Carte Oued el Bouach - Oued el Bouach

Carte Oued el Bouib - Oued el Bouib

Carte Oued el Bouira - Oued el Bouira

Carte Oued el Bouiret - Oued el Bouiret

Carte Oued el Bouni - Oued el Bouni Oued Bouni, Oued el Bouni

Carte Oued el Bour - Oued el Bour

Carte Oued el Boura - Oued el Boura

Carte Oued el Bourhari - Oued el Bourhari

Carte Oued el Boutr - Oued el Boutr

Carte Oued el Braigat - Oued el Braigat Oued el Bragaite, Oued el Bragaïte, Oued el Braigat, Oued el Braigate, Oued el Braïgat, Oued el Braïgate

Carte Oued el Bral - Oued el Bral

Carte Oued el Branis - Oued el Branis

Carte Oued el Breidj - Oued el Breidj Oued el Breidj, Oued el Breïdj, Oued el Bridj

Carte Oued el Bsal - Oued el Bsal

Carte Oued el Bseilat - Oued el Bseilat

Carte Oued el Bsibis - Oued el Bsibis

Carte Oued el Caid - Oued el Caid

Carte Oued el Chergui - Oued el Chergui

Carte Oued el Chorfa - Oued el Chorfa

Carte Oued el Djebana - Oued el Djebana

Carte Oued el Djeboub - Oued el Djeboub

Carte Oued el Djedari - Oued el Djedari Oued el Dejdari, Oued el Djedari

Carte Oued el Djedeiat - Oued el Djedeiat

Carte Oued el Djedj - Oued el Djedj

Carte Oued el Djefaira - Oued el Djefaira

Carte Oued el Djefna - Oued el Djefna

Carte Oued el Djefra - Oued el Djefra Oued Jefra, Oued el Djefra

Carte Oued el Djelid - Oued el Djelid

Carte Oued el Djema - Oued el Djema

Carte Oued el Djemaa - Oued el Djemaa Ferry, Oued Djemaa, Oued el Djemaa

Carte Oued el Djemel - Oued el Djemel

Carte Oued el Djenane - Oued el Djenane

Carte Oued el Djeraf - Oued el Djeraf

Carte Oued el Djerdjir - Oued el Djerdjir

Carte Oued el Djerf - Oued el Djerf Oued Djerof, Oued el Djerf, Oued el Djorf

Carte Oued el Djerob - Oued el Djerob

Carte Oued el Djezira - Oued el Djezira

Carte Oued el Djir - Oued el Djir Oued ed Djir, Oued el Djir

Carte Oued el Djirat - Oued el Djirat

Carte Oued el Djoucheni - Oued el Djoucheni

Carte Oued el Djoukh - Oued el Djoukh

Carte Oued el Djouza - Oued el Djouza

Carte Oued el Edmi - Oued el Edmi

Carte Oued el Emdad - Oued el Emdad

Carte Oued el Enkor - Oued el Enkor

Carte Oued el Ermets - Oued el Ermets

Carte Oued el Ethel - Oued el Ethel

Carte Oued el Euch - Oued el Euch

Carte Oued el Euch el Guebli - Oued el Euch el Guebli

Carte Oued el Ezab - O