[1]The following is a list of Disney stars from Disney Channel Original Series, Disney Channel Original Movies, Walt Disney Pictures, Disney XD & Disney+.

Contents: Top - 0â€“9 A B C D E F G H I J K L M N O P Q R S T U V W X Y Z

A[]

Aaryn Doyle - Lola Scott (Camp Rock)

Adam Irigoyen - Deuce Martinez (Shake It Up)

Alex Hirsch - Grunkle Stan Pines / Bill Cipher / Soos / Various characters (Gravity Falls), King / Hooty (The Owl House)

Anneliese van der Pol - Chelsea Daniels (That's So Raven and Raven's Home)

Alyson Michalka - Keely Teslow (Phil of the Future), Taylor Callum (Cow Belles)

Amanda Michalka - Courtney Callum (Cow Belles)

Adrienne Bailon - Alana Rivera (That's So Raven & Raven's Home), Chanel Simmons (The Cheetah Girls series)

Ashley Tisdale - Maddie Fitzpatrick (The Suite Life of Zack and Cody, Hannah Montana), Sharpay Evans (High School Musical),(High School Musical 2),(High School Musical 3: Senior Year), Camille Leon (Kim Possible), Candace Flynn (Phineas and Ferb)

Alison Fernandez - Classmate 1 (Vampirina), Chloe (Sydney to the Max), Pepper Paloma (Upside-Down Magic), Olivia (Raven's Home)

Amy Bruckner - Pim Diffy (Phil of the Future), Haley Long (American Dragon: Jake Long)

Alyson Stoner - Sally (Mike's Super Short Show), Max (The Suite Life of Zack and Cody), Ally (That's So Raven), Victoria (Lilo & Stitch: The Series), Isabella (Phineas and Ferb & Milo Murphy's Law), Caitlyn Gellar (Camp Rock & Camp Rock 2: The Final Jam), Kris/Lydia (Milo Murphy's Law), Lauren (aka The Destructress) (Hamster & Gretel)

Adam Lamberg - David Gordon (Lizzie McGuire)

Anna Maria Perez de Tagle - Ashley Dewitt (Hannah Montana), Ella (Camp Rock & Camp Rock 2: The Final Jam)

Adrian R'Mante - Esteban Ramirez (The Suite Life of Zack and Cody),

Allie Grant - Agnes (The Suite Life of Zack and Cody)

A.J. Trauth - Alan Tweety (Even Stevens)

Ashlie Brillault - Kate Sanders (Lizzie McGuire)

Arvie Lowe Jr - Mr. Digg (Lizzie McGuire)

Ashley Leggat - Casey MacDonald (Life with Derek), Marcia (Confessions of a Teenage Drama Queen)

Ashlyn Jade Lopez - Gabriella (Christmas Again)

Ariana Greenblatt - Daphne Diaz (Stuck in the Middle), Raina (Liv and Maddie)

Ariel Martin - Tiffany (Bizaardvark), Wynter (Z-O-M-B-I-E-S 2, Z-O-M-B-I-E-S 3 and Zombies: The Re-Animated Series), Herself (Disney Fam Jam)

Ariel Waller - Marti Venturi (Life with Derek)

Allisyn Ashley Arm - herself (Disney Channel's Totally New Year 2008), Zora Lancaster (Sonny With A Chance & So Random!)

Alexz Johnson - Annie Thelen (So Weird)

Alexandria Deberry - Paisley (A.N.T. Farm)

Ally Maki - Keiko Ishizuka (Shake It Up)

Amelia Wray - Sophia (Sydney to the Max)

Austin North - Logan Watson (I Didn't Do It)

Asher Angel - Jonah Beck (Andi Mack)

Anna Akana - Gloria Sato (Big City Greens), Sasha Waybright (Amphibia), Odessa Drake (Marvel's Moon Girl and Devil Dinosaur)

Anna Cathcart - Dizzy Tremaine (Descendants 2, Descendants 3), Molly (Spin)

Ava Kolker - Ava Morgenstern (Girl Meets World), Olive Rozalski (Sydney to the Max)

Avantika Vandanapu - Kamala (Mira, Royal Detective), Monyca (Diary of a Future President), Rhea Kumar (Spin)

Albert Tsai - Fred (Coop & Cami Ask the World)

August Maturo - Auggie Matthews (Girl Meets World)

Alfred Lewis - Bill Pickett (Bunk'd)

Aedin Mincks - Angus Chestnut (A.N.T. Farm)

Andrew Caldwell - Thor (Hannah Montana), Gravy (Good Luck Charlie), Sam (Cloud 9), Ted (Bunk'd)

Aramis Knight - Boy #3 (Hannah Montana), Wendell Pate (Hatching Pete), Brandon (Girl Meets World)

Auli'i Cravalho - Veronica (Elena of Avalor), Hailey Banks (Hailey's On It!)

Amanda Leighton - Polly Plantar (Amphibia), Kristine (Hailey's On It!)

Ashly Burch - Molly McGee (The Ghost and Molly McGee)

Aryan Simhadri - Henry (Gamer's Guide to Pretty Much Everything), Kabir (Fancy Nancy), Norvin Schnuckle (Just Roll With It), Dhruv Sharma (Mira, Royal Detective), Rohan Kumar (Spin)

America Ferrera - Yolanda (Gotta Kick It Up!)

Andrew Lawrence - Tommy Biggs (Horse Sense and Jumping Ship), Will Browning/Twoie (The Other Me), Jace Newfield (Going to the Mat)

Adora Sheikh - Layla (Pretty Freekin Scary)

Arjun Sriram - Pete (Sydney to the Max)

Ayden Elijah - Albert Reyes (The Naughty Nine)

Anthony Joo - Lewis Sobong (The Naughty Nine)

Alkaio Thiele - Roman Russo (Wizards Beyond Waverly Place)

Alex Boniello - Jack of Diamonds (Descendants: The Rise of Red)

Anthony Pyatt - Teen Hades (Descendants: The Rise of Red)

Aiza Azaar - Teen Jasmine (Descendants: The Rise of Red)

B[]

Bella Thorne - Nancy (Wizards of Waverly Place), CeCe Jones (Shake It Up), Avalon Greene (Frenemies), Jolie (K.C. Undercover)

Billy Ray Cyrus - Robby Stewart (Hannah Montana), (Hannah Montana: The Movie), Buck Buckerson (Phineas and Ferb)

Brenda Song - London Tipton (The Suite Life of Zack and Cody and The Suite Life On Deck), Wendy (Wendy Wu: Homecoming Warrior), Jennifer (Get A Clue), Natasha Kwon-Schwartz (Stuck in the Suburbs), Tia (Phil Of The Future), Samantha Kwan (The Ultimate Christmas Present), Anne Boonchuy (Amphibia)

Brian Stepanek - Arwin Hawkhauser (The Suite Life of Zack and Cody), Himself (Brian O' Brian)

Brittany Curran - Chelsea (The Suite Life of Zack and Cody)

Brandon Baker - Zack (Even Stevens) Johnny Kapahala (Johnny Tsunami), (Johnny Kapahala: Back on Board)

Bridgit Mendler - Penny (JONAS), Juliet Van Heuson (Wizards of Waverly Place), Teddy Duncan (Good Luck Charlie), Olivia White (Lemonade Mouth)

Brent Tarnol - Josh (Sonny With A Chance)

Brandon Mychal Smith- Lil' Danny Dawkins (Phil of the Future), Razor (That's So Raven), Nico Harris (Sonny With a Chance & So Random!), Bling (Let It Shine) Stubby (Starstruck), JT (Hailey's On It!)

Belinda Metz - Irene Bell (So Weird)

Blake Michael - Charlie Delgado (Lemonade Mouth), Tyler James (Dog with a Blog)

Booboo Stewart - Kai (Good Luck Charlie), Jay (Descendants, Descendants 2, Descendants 3), Kevin (Big City Greens)

Benjamin King - Pete Rooney (Liv and Maddie)

Bradley Steven Perry - Gabe Duncan (Good Luck Charlie), Roger Elliston (Sharpay's Fabulous Adventure), Kaz (Mighty Med, Lab Rats: Elite Force)

Benjamin Cole Royer - Bret Marcus (Best Friends Whenever)

Ben Savage - Cory Matthews (Girl Meets World)

Beth Littleford - Ellen (Dog with a Blog)

Brandon Rossel - Cody (Fast Layne), Santiago Rodriguez/Tiago (Ultra Violet & Black Scorpion)

Bryan Blanco - Luis Leon (Ultra Violet & Black Scorpion)

Buddy Handleson - Boy (Hannah Montana), Henry Dillon (Shake It Up), Gerald (Sydney to the Max)

Beck Bennett - Hamster (Hamster & Gretel)

Brenna D'Amico - Jane (the Descendants series)

Brandon Severs - Dusty (Walk the Prank), Lil' Z (Raven's Home), Liam (Diary of a Future President), Ken (Bunk'd)

Brogan Hall - Bucky (Sydney to the Max)

Bryce Gheisar - Herman (Walk the Prank)

Bailee Madison - Maxine Russo (Wizards of Waverly Place)

C[]

Calum Worthy - Dez Wade (Austin & Ally), Himself and various characters (The Coppertop Flop Show)

Carrie Wampler - Brooke (Austin & Ally)

Caroline Sunshine - Tinka Hessenheffer (Shake It Up)

China Anne McClain - Isabel (Hannah Montana) Kiara Tyshana (JONAS) Tina (Wizards of Waverly Place) Chyna Parks (A.N.T. Farm), Gabby Harrison (How to Build a Better Boy), Uma (Descendants 2, Descendants 3 & Descendants: The Rise of Red)

Christy Carlson Romano - Capt. Jennifer (Cadet Kelly), Kim Possible (Kim Possible), Ren Stevens (Even Stevens)

Cole Sprouse - Cody Martin (The Suite Life of Zack and Cody and The Suite Life On Deck), Eddie Tudor (The Prince and The Pauper)

Cody Linley - Jake Ryan (Hannah Montana)

Corbin Bleu - Chad Danforth (High School Musical,High School Musical 2, High School Musical 3: Senior Year), Johnny Collins (Hannah Montana), Isadore (Izzy) Daniels (Jump In!), Himself (High School Musical: The Musical: The Series)

Caroline Rhea - Ilsa Shickelgrubermeiger-Von Helsing der Keppelugerhofer/Hotel Inspector (The Suite Life of Zack and Cody), Linda/Lindana Flynn (Phineas and Ferb), Lynette/Mom(Mom's Got A Date With A Vampire), Judy Reynolds (Sydney to the Max)

Chandler Kinney - Vanessa (Girl Meets World), Monique (K.C. Undercover), Willa (Z-O-M-B-I-E-S 2, Zombies: Addison's Moonstone Mystery, Z-O-M-B-I-E-S 3 & Zombies: The Re-Animated Series), Tammy (The Ghost and Molly McGee)

Charlotte Arnold - Sadie Hawthorne (Naturally, Sadie)

Chris Warren Jr - Zeke Baylor (High School Musical, High School Musical 2, High School Musical 3: Senior Year), Justin (Good Luck Charlie)

Crystal Walker - Tanya Baxter (That's So Raven)

Craig Anton - Lloyd Diffy (Phil of the Future) Mr. Pettus (Lizzie McGuire)

Come Levin - (Disney Channel France)

Charlie Stewart - Bob (The Suite Life of Zack and Cody)

Camilla Rosso - Janice (The Suite Life of Zack and Cody)

Chelsea Staub - Stephanie (Minutemen) Stella Malone (J.O.N.A.S.) Bea Goldfishberg (Fish Hooks) Alexis Bender (Starstruck)

Carlson Young - Tiffany (As The Bell Rings)

Collin Cole - Skipper (As The Bell Rings)

Clayton Snyder - Ethan Craft (Lizzie McGuire)

Carly Schroeder - Melina Bianco (Lizzie McGuire)

Chez Starbuck - Cody Griffin - (The Thirteenth Year)

Christian J. Simon - Leo Webb (Sydney to the Max), Gilbert (Under Wraps & Under Wraps 2)

Carrie Kei Heim - Nikki Ferris (The Parent Trap 2)

Cara DeLizia - Fi (Fiona) Phillips (So Weird)

Coco Christo - Olivia Duran (Gabby Duran & the Unsittables)

Coco Jones - Roxie Andrews (Let It Shine), Kelsey (Good Luck Charlie)

Cole Sand - Nelson (Austin & Ally),

Cyrina Fiallo - Vonnie (Good Luck Charlie)

Cameron Boyce - Luke Ross (Jessie & Bunk'd), Connor (Gamer's Guide to Pretty Much Everything), Carlos de Vil (Descendants series)

Callan Farris - Jeremy (Gabby Duran & the Unsittables)

Carlon Jeffery - Cameron (A.N.T. Farm), Dink (Cloud 9)

Corey Fogelmanis - Shamus Farkle (Girl Meets World)

Ciara Wilson - Athena (Kim Possible (film))

Carla Jeffery - Jean (Good Luck Charlie), Margie (Shake It Up), Karen (Best Friends Whenever), Bree (Z-O-M-B-I-E-S, Z-O-M-B-I-E-S 2, Z-O-M-B-I-E-S 3 and Zombies: The Re-Animated Series)

Cody Christian - Elliot (Austin & Ally)

Cozi Zuehlsdorff - Ocean (Liv and Maddie), Pinky (K.C. Undercover), Ellie Blake (Freaky Friday)

Cooper Andrews - Kai Banks (Hailey's On It!)

Charlyne Yi - The Guardian (Amphibia), Larry (StuGo)

Connor Weil - Logan (A.N.T. Farm), Spencer (Crash & Bernstein), Miller (Liv and Maddie), J.P. (Kickin' It), Brady (K.C. Undercover)

Cassidey Fralin - Young Alisha (Sydney to the Max)

Cody Veith - Chance (Walk the Prank)

Cameron Palatas - Jared (A.N.T. Farm), Tom Bigham (I Didn't Do It)

Camila Rodriguez - Dulce Gutierrez (The Naughty Nine)

Clara Stack - Rose Wingert (The Naughty Nine)

Candace Kozak - Ruth Buth (Just Roll With It), Young Nancy (Big City Greens)

D[]

Danielle Panabaker - Brittany Aarons (Stuck in the Suburbs), Is (Read It and Weep)

Dylan Sprouse - Zack Martin (The Suite Life of Zack and Cody), (The Suite Life on Deck), Tom Canty (The Prince and The Pauper)

David Henrie - Larry (That's So Raven), Justin Russo (Wizards of Waverly Place, Wizards of Waverly Place: The Movie and Wizards Beyond Waverly Place), Wheeze (Dadnapped)

David Kaufman - Aldrin Pesky (The Buzz on Maggie)

Daran Norris - Dick Darring (The Replacements)

David McCallum - C.A.R. (The Replacements)

David DeLuise - Jerry Russo (Wizards of Waverly Place), Dad (Mostly Ghostly: Who Let the Ghosts Out?)

Dee Bradley Baker - Perry the Platypus (Phineas and Ferb)

David Reivers - Kenneth Daniels (Jump In!)

Davis Cleveland - Flynn Jones (Shake It Up) and River Star (Star Family)

Donna Pescow - Eileen Stevens (Even Stevens)

Dave Coulier - Lance Lebow (The Even Stevens Movie), Whit Griffin (The Thirteenth Year)

Dante Basco - Madrid (The Suite Life of Zack and Cody), Jake Long (American Dragon: Jake Long)

Demi Lovato - Charlotte Adams (As the Bell Rings), Mitchie Torres (Camp Rock), Sonny Munroe (Sonny With A Chance), Princess Rosalinda 'Rosie' (Princess Protection Program)

Davida Williams - Veronica (J.O.N.A.S.)

Debby Ryan - Bailey Pickett (The Suite Life on Deck), Abby Jensen (16 Wishes), Jessie Prescott (Jessie), Tara Adams (Radio Rebel)

Durell Green - football player

Daniel Magder- Edwin Venturi (Life with Derek)

Dan Povenmire - Dr. Doofenshmirtz (Phineas and Ferb, Milo Murphy's Law, Chibiverse & Hamster & Gretel), Vinnie Dakota (Milo Murphy's Law), Unseen alien #1 (Hamster & Gretel)

Daniel Roebuck - Mr. Condor (Sonny With A Chance)

Dove Cameron - Liv Rooney / Maddie Rooney (Liv and Maddie), Kayla Morgan (Cloud 9), Bobbie (Austin & Ally), Mal (Descendants)

Dakota Lotus - Coop Wrather (Coop & Cami Ask the World)

Danielle Fishel - Topanga Matthews (Girl Meets World)

Doug Brochu - Grady Mitchell (Sonny With A Chance & So Random!)

DeVore Ledridge - Amelia Duckworth (Bizaardvark)

Diandra Lyle - Jess Dunn (Secrets of Sulphur Springs)

Doc Shaw- Marcus Little (The Suite Life On Deck)

Danielle Jalade - Paris Johnson (Saturdays)

Daria Johns - Simone Samson (Saturdays)

Diamond White - Fuli (The Lion Guard), Ruby Hanshaw (Sofia the First), Holly (Phineas and Ferb), Sage (Girl Meets World), Lunella Lafayette/Moon Girl (Marvel's Moon Girl and Devil Dinosaur)

Dan Benson - Sterling (Phil of the Future), Zeke Beakerman (Wizards of Waverly Place)

Deborah Baker Jr. - Sara (StuGo)

Dora Dolphin - Shadow (The Villains of Valley View)

Dallas Dupree Young - Benny (Sydney to the Max)

Derek Theler - Blue Granite (The Villains of Valley View), Bruno (The Naughty Nine)

Deric McCabe - Jon Anthony Dizon (The Naughty Nine)

E[]

Emily Osment - Lilly (Hannah Montana) Melissa Morris (Dadnapped) Gerti Giggles (Spy Kids 2: Island of Lost Dreams) + (Spy Kids 3D: Game Over)

Eden Sher - Lucy (Sonny With A Chance), Star Butterfly (Star vs. the Forces of Evil)

Elie Samouhi - Rodney (Bizaardvark), Elliot Cohen (Upside-Down Magic)

Elle Graham - Savannah Dillon (Secrets of Sulphur Springs)

Elisa Donovan - Sharona (Sonny With A Chance)

Eric Lively - Carey Bell (So Weird)

Erik Von Detten - Clu Bell (So Weird)

Eric Allan Kramer - Bob Duncan (Good Luck Charlie), Coach Carlock (Sydney to the Max)

Ethan Wacker - Collin Cleveland (K.C. Undercover), Bernie Schotz (Bizaardvark)

Emmy Liu-Wang - Ivy (Raven's Home), Paige (The Slumber Party)

Eliana Su'a - Frankie Ripp (Pretty Freekin Scary)

Emma Shannon - Nyx (Pretty Freekin Scary)

Eugene Cordero - Mr. Ordonia (Star vs. the Forces of Evil), The Pone/Secretary Prince (Kiff)

Emilia McCarthy - Taylor Dean (Zapped), Lacey (Z-O-M-B-I-E-S series)

Ephraim Sykes - Bobby the Myth (Marvel's Moon Girl and Devil Dinosaur)

F[]

Frances Callier - Roxy (Hannah Montana)

Frankie Jonas - Himself (The Jonas Brothers: Livin The Dream) and Frankie Lucas (JONAS) (Jonas Brothers: The 3D Concert Experience) (Camp Rock 2)

Francesca Capaldi - Chloe James (Dog with a Blog)

Felix Avitia - Franklin (Gamer's Guide to Pretty Much Everything), Neil (Raven's Home)

Freya Skye - Nova (Z-O-M-B-I-E-S 4: Dawn of the Vampires)

G[]

Grey Delisle - Riley (The Replacements)

Giovonnie Samuels - Nia (The Suite Life of Zack and Cody)

Golan Yosef - JoaquÃ­n (The Cheetah Girls 2)

Gary Cole - Joe Maxwell (Cadet Kelly), Dr. "Mr." Possible (Kim Possible)

Giulia Boverio - Disney Channel Italy

Greg Baker - Mr. Corelli (Hannah Montana)

Gabriela Rodriguez- Brooke (As The Bell Rings)

G. Hannelius - Dakota (Sonny With A Chance), Amy Little (Leo Little's Big Show), Tiffany (Hannah Montana) Jo Keener (Good Luck Charlie), Avery Jennings (Dog with a Blog), Amanda (Fish Hooks), Mackenzie (Jessie), Lady Joy (Sofia The First), Little Bits (Wander Over Yonder)

Gloria Cromwell - Florence (The Parent Trap 2)

Garrett Clayton - Tanner (Teen Beach Movie), (Teen Beach Movie 2), TJ Star (Star Family)

Gregg Sulkin - Mason (Wizards of Waverly Place), William Wagner (Avalon High)

Gus Kamp - Barry (Best Friends Whenever)

Golden Brooks - Deb Johnson (Saturdays)

Gary LeRoi Gray - Nelson Minkler (Even Stevens)

Gabourey Sidibe - Francis (StuGo)

Grace Narducci - Fay (Descendants: The Rise of Red)

H[]

Hallie Todd - Jo (Lizzie McGuire)

Hannah Kat Jones - Carrie (Austin & Ally),

Hayden Panettiere - Maddie Dolan (Tiger Cruise), a singer

Haylie Duff- Cousin Amy (Lizzie McGuire)

Hal Smith - Winnie The Pooh and Owl (Welcome To Pooh Corner)

Hayley Mills - Pollyanna Whittier (Pollyanna), Sharon McKendrick and Susan Evers (The Parent Trap) (The Parent Trap 2) (The Parent Trap 3) (The Parent Trap 4: Hawaiian Honeymoon), Mary Grant (In Search of the Castaways), Nancy Carey (Summer Magic), Nikky Ferris (The Moon-Spinners), Patricia Patti Randall (That Darn Cat), Miss Carrie Bliss (Good Morning, Miss Bliss)

Hilary Duff - Lizzie (Lizzie McGuire), Kelly (Cadet Kelly)

Haley Tju - Girl (Hannah Montana), Young London Tipton (The Suite Life On Deck), Tina Destiny (Den Brother), Eileen Miller (Jessie), Zoe (K.C. Undercover), Karmi (Big Hero 6: The Series), Marcy Wu/Darcy (Amphibia)

H. Michael Croner - Barry (Kiff)

Hayley Kiyoko - Stevie Nichols (Wizards of Waverly Place), Stella Yamada (Lemonade Mouth)

I[]

Issac Ryan Brown - Bingo (Puppy Dog Pals), Booker Baxter-Carter (Raven's Home), Wade (Kim Possible (film))

Isaak Presley - Ethan Diaz (Stuck in the Middle), Max (Austin and Ally)

Ian Reed Kesler - Max Reynolds (Sydney to the Max)

Izabela Rose - Nory Boxwood Horace (Upside-Down Magic), Young Jess (Secrets of Sulphur Springs)

Isabella Pappas - Amy/Havoc (The Villains of Valley View)

Israel Johnson - Noah Lambert (Bunk'd)

Izzy Lieberman - Bryce (Sydney to the Max)

Imogen Cohen - Cleo (Bunk'd), Ha-Yoon Si-u (The Naughty Nine)

J[]

Jackson Dollinger - Young Max (Sydney to the Max), Dio (Pretty Freekin Scary)

Jake Thomas - Matt (Lizzie McGuire), Jason Stickler (Cory in the House)

Jasmine Richards - Margaret Browning-Levesque (Naturally, Sadie), Peggy (Camp Rock),

Jason Dolley - Newt (Cory in the House), Connor (Read It and Weep), Virgil (Minutemen), Pete Ivey (Hatching Pete), PJ (Good Luck Charlie)

Jason Ritter - Dipper Pines (Gravity Falls)

Jean Smart - Dr. "Mrs." Possible (Kim Possible)

Josie Lopez - Angela Morrisey (Hatching Pete)

Josie Tysoe - Staily (Camp Rock)

Jason Earles - Jackson (Hannah Montana), Merv (Dadnapped), Sensei Rudolph "Rudy" Jervis Gillespie (Kickin' It), Dewey Wood (High School Musical: The Musical: The Series)

Jake T. Austin - Chris (Johnny Kapahala: Back on Board), Max (Wizards of Waverly Place), (Wizards of Waverly Place: The Movie)

Jason Maybaum - Levi Grayson (Raven's Home), Fletcher (Freaky Friday)

Jeff Bennett - Mr. Tipton (voice) (The Suite Life of Zack and Cody), Mr. Long (American Dragon: Jake Long), Principal Peststrip (The Buzz on Maggie), Kowalski (The Penguins Of Madagascar)

Jenna Ortega - Harley Diaz (Stuck in the Middle), Princess Isabel (Elena of Avalor), Gabriella (Big City Greens)

Jennifer Stone - Harper (Wizards of Waverly Place)

John D'Aquino - President Martinez (Cory in the House)

Joe Jonas - Joe Lucas (J.O.N.A.S.), Shane Gray (Camp Rock)

J.P. Manoux - Curtis, Vice Principal Hacket (Phil of the Future), Kuzco in replacing of David Spade in (The Emperor's New School), Vice Principal Tolkan (Minutemen)

Jerry Krenion - Chef Paolo (The Suite Life of Zack and Cody)

Jessica DiCicco - Maggie Pesky (The Buzz on Maggie), Melina (The Emperor's New School)

Joey Bragg - Joey Rooney (Liv and Maddie)

Jordan Todosey - Lizzie MacDonald (Life with Derek)

Joy Tanner - Nora MacDonald (Life with Derek)

John Ralston- George Venturi (Life with Derek)

John Taylor - Mr Castello (Joe's History Teacher) (JONAS)

Joshua Bassett - Aidan Peters (Stuck in the Middle), Ricky Bowen (High School Musical: The Musical: The Series)

Joshua Rush - Bunga (The Lion Guard), Cyrus Goodman (Andi Mack)

Jillian Murray - Portlyn (Sonny With A Chance), cute girl (Drake and Josh)

Judith Tannen - Jesicca Dintroff (The Parent Trap 2)

Julia Garcia - Emmy Mendoza (Sydney to the Max)

Jun Saylon - Adam Moore (My Twin Brother Is A Zombie)

Justin Chon - Peter Wu (Wendy Wu: Homecoming Warrior)

James Patrick Stuart - Lance (Shake It Up), Col. Prescott (Jessie), One-Eyed Wally (Amphibia), Vic/Kraniac (The Villains of Valley View)

Jake Short - Fletcher (A.N.T. Farm), Oliver (Mighty Med, Lab Rats & Lab Rats: Elite Force)

Jake Paul - Dirk Mann (Bizaardvark)

J.R. Villarreal - Cruz de la Vega/Black Scorpion (Ultra Violet & Black Scorpion)

Juan Alfonso - Juan Carlos Rodriguez (Ultra Violet & Black Scorpion)

Josh Braaten - Ben Campbell (Secrets of Sulphur Springs)

Johari Washington - Topher Dunn (Secrets of Sulphur Springs)

Jermaine Harris - Guion (Bunk'd), London Johnson (Saturdays)

JC Currais - The Gator (Just Roll With It)

Jet Jurgensmeyer - Stevie (Austin & Ally), Bobby Anderson (Adventures in Babysitting)

Jordan Fisher - Holden Dippledorf (Liv and Maddie), Seacat (Teen Beach Movie & Teen Beach 2), Jamie Porter (High School Musical: The Musical: The Series)

Jace Norman - Finch (Jessie)

Joshua Carlon - Theo (Bizaardvark)

Jadon Sand - Cubby (Jake and the Never Land Pirates), Young Gibson (A.N.T. Farm), Kazeem (Sofia the First)

James Godfrey - Porter Gibbs (The Swap), Bonzo (the Z-O-M-B-I-E-S series)

Joey King - Emily Mason (The Suite Life of Zack & Cody), Fred Grant (Hamster & Gretel)

Jahbril Cook - Watson (Spin)

Jack Griffo - Brett Summers (Jessie)

Jayden Bartels - Peyton (Coop & Cami Ask the World)

Jessica Marie Garcia - Willow Cruz (Liv and Maddie)

Jermaine Fowler - James Lafayette Jr. (Marvel's Moon Girl and Devil Dinosaur)

Jaidyn Triplett - Scarlett (The Villains of Valley View), Ruby (Secrets of Sulphur Springs)

James DiGiacomo - Petey Goldfeder (K.C. Undercover)

Joshua Gonzalez - Derek (Sydney to the Max)

Joachim Powell - LJ Webb (Sydney to the Max)

Jillian Shea Spaeder - Bailey (Walk the Prank), Bum-Around Bobbi (Just Roll With It), Jane (Godmothered)

Josh Brener - Mark Beaks (DuckTales), Neeku Vozo (Star Wars Resistance), A.C. (Hailey's On It!)

Josh Johnson - Harry Buns (Kiff)

Janice LeAnn Brown - Helen (Just Roll With It), Billie (Wizards Beyond Waverly Place)

Julian Lerner - Ray (Z-O-M-B-I-E-S 4: Dawn of the Vampires)

Jonno Roberts - Commander Bright (Z-O-M-B-I-E-S 4: Dawn of the Vampires)

Joshua Colley - Young Hook (Descendants: The Rise of Red)

Julia Lester - Ashlyn Caswell (High School Musical: The Musical: The Series), Tina (Hailey's On It!)

K[]

Karan Brar - Ravi Ross (Jessie & Bunk'd), George (Invisible Sister), Prince Veer (Mira, Royal Detective), Sanjay Singh (Hailey's On It!)

Katie Leigh - additional voices (Aladdin) (Rugrats), Jr. Harris and Jr. Harris Jr. (As Told By Ginger), Honker Muddlefoot (Darkwing Duck), Dumbo (Dumbo's Circus), Sunni Gummi (Disney's Adventures of the Gummi Bears), Little Miss Chatterbox, Little Miss Daredevil, and Little Miss Helpful (The Mr. Men Show), Alex (Totally Spies!), Various boys (Hi Hi Puffy Ami Yumi), Mean Boy (Barnyard)

Kay Panabaker- Jamie Bartlett (Read It and Weep), Amber (The Suite Life of Zack and Cody), Emily Watson (Life Is Ruff), Debbie Burwick (Phil of the Future)

Kelly Blatz - Charlie Landers/Aaron Stone (Aaron Stone), James Conroy (Sonny With A Chance)

Kenton Duty - Gunther Hessenheffer (Shake It Up)

Kevin Jonas - Kevin Lucas (J.O.N.A.S.), Jason (Camp Rock)

Kim Rhodes - Carey Martin (The Suite Life of Zack and Cody) Mom (Mostly Ghostly: Who Let the Ghosts Out?)

Kimberly J. Brown - Marnie Piper (Halloweentown, Halloweentown II: Kalabar's Revenge & Halloweentown High), Blair (The Ghost and Molly McGee)

Kaycee Stroh - Martha Cox (High School Musical), (High School Musical 2), (High School Musical 3: Senior Year) Leslie (The Suite Life of Zack and Cody), Herself (High School Musical: The Musical: The Series)

Keke Palmer - Mary (Jump In!)

Kerri Medders - Ginger (Spin)

Kiely Williams - Aquanette Walker (The Cheetah Girls), (The Cheetah Girls 2), (The Cheetah Girls: One World) Herself (The Suite Life of Zack and Cody)

Kiersey Clemons - Danielle (Shake It Up), Kira Starr (Austin & Ally), Skye Sailor (Cloud 9)

Kristen Schaal - Mabel Pines (Gravity Falls)

Kristen Stewart - Maddy (Catch That Kid)

Kroopa Gandhi - Maya (Wizards of Waverly Place)

Kyla Pratt - Penny Proud (The Proud Family, The Proud Family Movie, The Proud Family: Louder and Prouder & Lilo & Stitch: The Series)

Kyle Massey - Cory Baxter (That's So Raven), (Cory in the House) Calvin Wheeler (Life Is Ruff), Milo (Fish Hooks)

Kylie Cantrall - Tessa (Bizaardvark), Jasmine Sleevemore (Raven's Home), Gabby Duran (Gabby Duran & The Unsittables), Red (Descendants: The Rise of Red)

Kyliegh Curran - Harper (Secrets of Sulphur Springs)

Kaylin Hayman - Blair (Just Roll With It)

Kevin Chamberlin - Bertram (Jessie & Bunk'd), Dr. Fusion (Teen Beach Movie)

Kali Rocha - Karen Rooney (Liv and Maddie)

Kayla Maisonet - Lindsay (Dog with a Blog), Georgie Diaz (Stuck in the Middle)

Kevin G. Quinn - Xander (Bunk'd), Zac Chase (Adventures in Babysitting)

Kayden Muller-Janssen - Hartley (The Villains of Valley View)

Kadeem Hardison - Craig (K.C. Undercover)

Kamil McFadden - Ernie (K.C. Undercover)

Kelly Frye - Sarah Campbell (Secrets of Sulphur Springs)

Kingston Foster - Zoey Necrodopolis (Z-O-M-B-I-E-S, Z-O-M-B-I-E-S 2, Z-O-M-B-I-E-S 3), Tex (Just Roll With It)

Kyra Tantao - A-Li (Z-O-M-B-I-E-S 3)

Kelli Berglund - Bree Davenport (Lab Rats, Lab Rats: Elite Force), Sloane Jennings (Kickin' It), Mae Hartley (How to Build a Better Boy)

Katherine McNamara - Myra Santelli (Girl vs. Monster), Claire (Kickin' It), Bryn Breitbart (Jessie)

Kyan Samuels - Pretty (Pretty Freekin Scary)

Kari Wahlgren - Helen (Wizards of Waverly Place), Suzy Johnson (Phineas and Ferb), Shellsea (Fish Hooks), Grimbella (The Ghost and Molly McGee), Stiletto (Marvel's Moon Girl and Devil Dinosaur)

Kimiko Glenn - Lena (DuckTales), Kiff Chatterley (Kiff)

Kaley Cuoco - Elisa Bowers (Alley Cats Strike), Brandy Harrington (Brandy & Mr. Whiskers)

Kylee Russell - Karin Daniels (Jump In!), Eliza Zambi (the Z-O-M-B-I-E-S series)

Kaiel Barreiro - Kyle (Gabby Duran & the Unsittables)

Kathryn Newton - Emily Adams (Dog with a Blog)

Kira Kosarin - Raina Kumar (Shake It Up)

Kabir Bery - Teenage Aladdin (Descendants: The Rise of Red)

Kahyun Kim - Dae (Zombies: The Re-Animated Series)

L[]

Lalaine Vergara-Paras - Miranda Sanchez (Lizzie McGuire), Abby (You Wish!)

Laura Marano - Ally Dawson (Austin and Ally), Monica Reeves (Bad Hair Day)

Leigh Allyn Baker - Mickey (Hannah Montana), Amy Duncan (Good Luck Charlie), Liz Morgan (Bad Hair Day)

Leo Howard - Leo Little (Leo Little's Big Show), Jack Brewer (Kickin' It), Logan Hunter (Shake It Up)

Leven Rambin - Rosie (Wizards of Waverly Place)

Linda Cardellini - Wendy (Gravity Falls)

Lindsay Lohan - Hallie Parker / Annie James (The Parent Trap), Lexy Gold (Get A Clue), Anna Coleman (Freaky Friday), Mary Elizabeth "Lola" Step (Confessions of a Teenage Drama Queen), Maggie Peyton (Herbie: Fully Loaded)

Lindsey Black - Lexi Adams (As The Bell Rings)

Lucas Grabeel - Ryan Evans (High School Musical), (High School Musical 2), (High School Musical 3), Ethan (Halloweentown High), (Return To Halloweentown)

Lise Simms - Barbara Diffy (Phil of the Future)

Lisa Arch - Samantha Samuels (Cory in the House), Liza (Hannah Montana)

Luke Benward - Charlie (Minutemen), William Cloud (Cloud 9), Thor (Girl Meets World)

Lily Holleman - Assistant (Sonny With A Chance)

Lauren Taylor - Shelby Marcus (Best Friends Whenever)

Landry Bender - Cyd Ripley (Best Friends Whenever)

Landon Gordon - Wyatt Campbell (Secrets of Sulphur Springs)

Lauren Lindsey Donzis - Ruby (Liv and Maddie)

Lucy Davis - Eva/Surge (The Villains of Valley View)

Luke Busey - Jake Jacobs (Bunk'd)

Leah Mei Gold - Scary (Pretty Freekin Scary)

Lauren Frost - Ruby (Even Stevens and The Even Stevens Movie)

L.J. Benet - Little Crumbs (Wizards of Waverly Place), Karl Fink (Dog With a Blog)

Lucas Adams - Josh Wilcox (Liv and Maddie)

Luca Alexander - Zach Thompson (Sydney to the Max)

Lorraine Toussaint - Rashida Remington (Big City Greens), Dr. Lullah (StuGo)

Lucy Hale - Miranda Hampson (Wizards of Waverly Place)

Lisa Chappell - Eldress (Z-O-M-B-I-E-S 4: Dawn of the Vampires)

Leonardo Nam - Maddox (Descendants: The Rise of Red)

M[]

Maiara Walsh - Meena Paroom (Cory in the House)

Madison Hu - Marci (Best Friends Whenever), Frankie Wong (Bizaardvark)

Madison Pettis - Sophie Martinez (Cory in the House), Payton Kelly (The Game Plan), Adyson Sweetwater (Phineas and Ferb)

Max Torina - Ramon (Raven's Home), Luke (Sydney to the Max), Andres Padillo (Upside-Down Magic)

Maxwell Simkins - Zane (Bizaardvark), Young Drakken (Kim Possible (film))

Malachi Barton - Beast Diaz (Stuck in the Middle), Jasper Flores (Bunk'd), Tyber (Just Roll With It), Marshall (Under Wraps & Under Wraps 2) Colby/Flashform (The Villains of Valley View), Victor (Z-O-M-B-I-E-S 4: Dawn of the Vampires)

Meg Donnelly - Addison (Z-O-M-B-I-E-S series), Priscilla (Bunk'd), Val (High School Musical: The Musical: The Series)

Mia Talerico - Charlie Duncan (Good Luck Charlie, Good Luck Charlie, It's Christmas!)

Miley Cyrus - Miley Stewart/Hannah Monatana (Hannah Montana), (Hannah Montana: The Movie), Yatta (The Emperor's New School), Celebrity Star (The Replacements), dancing cameo (High School Musical 2)

Michael Seater - Derek Venturi (Life with Derek)

Meaghan Jette Martin - Tess Tyler (Camp Rock), Stacy (The Suite Life of Zack and Cody)

Margo Harshman- Tawny Dean - (Even Stevens)

Mitchel Musso - Oliver Oken (Hannah Montana) Jeremy (Phineas and Ferb) Raymond Figg (Life Is Ruff)

Monique Coleman - Taylor McKessie (High School Musical), (High School Musical 2), (High School Musical 3: Senior Year), Mary-Margaret (The Suite Life of Zack & Cody)

Michael Kostroff - Marshall Pike (Sonny With A Chance)

Mackenzie Phillips - Molly Phillips (So Weird)

Miranda May - Lou (Bunk'd)

Milo Manheim - Zed Necrodopolis (Z-O-M-B-I-E-S series), Ben (Prom Pact)

Maxwell Acee Donovan - Wesley (Gabby Duran & the Unsittables)

Madeleine McGraw - Zoey Campbell (Secrets of Sulphur Springs)

Maria Canals Barrera - Theresa Russo (Wizards of Waverly Place), Connie Torres (Camp Rock)

Matthew Lewis Royer - Chet Marcus (Best Friends Whenever)

Mallory James Mahoney - Katy Cooper (Adventures in Babysitting), Destiny Baker (Bunk'd)

Moises Arias - Rico (Hannah Montana), Andre (Dadnapped)

Mykal-Michelle Harris - Alice Baxter (Raven's Home and Alice in the Palace)

Marianna Burelli - Nina Rodriguez (Ultra Violet & Black Scorpion)

Marieve Herington - Tilly Green (Big City Greens & Chibiverse), Jilly McGee (The Ghost and Molly McGee)

Matt Cornett - E.J. Caswell (High School Musical: The Musical: The Series), A-Lan (Z-O-M-B-I-E-S 3)

Matthew Timmons - Woody Fink (The Suite Life On Deck & The Suite Life Movie), Max (Jessie)

Matt Shively - Hudson (Jessie), Bart Hartley (How to Build a Better Boy)

Maia Mitchell - Shaylee Michaels (Jessie), Mack (Teen Beach Movie & Teen Beach 2)

Manny Jacinto - Scott (Hailey's On It!)

Michael Cimino - Kevin Grant-Gomez (Hamster & Gretel), Eduardo (Marvel's Moon Girl and Devil Dinosaur)

Meli Povenmire - Gretel Grant-Gomez (Hamster & Gretel)

Mitchell Hope - King Ben (the Descendants series)

Marissa Reyes - Cami Rivera (Raven's Home)

Myrna Velasco - CJ Hook (Descendants: Wicked World), Mimi Mendoza (Sydney to the Max), Carla Delgado / Rita (Elena of Avalor), Torra Doza (Star Wars Resistance), Kim (Big City Greens), Gloria / Mrs. Sanchez (Hailey's On It!), Tater Ramirez Humphrey (Primos)

Maddie Ziegler - Shelby (Austin & Ally)

Madilyn Kellam - Laurel Steele (The Naughty Nine)

Matthew Scott Montgomery - A.D. (Shake It Up), Matthew Bailey (So Random!), Walter (Austin & Ally)

Mekai Curtis - Felix Shumpert (Girl Meets World), Fish Fisher (Kirby Buckets), Fuhara (The Lion Guard), Zack Underwood (Milo Murphy's Law)

Mimi Gianopulos - Giada Russo (Wizards Beyond Waverly Place)

Max Matenko - Milo Russo (Wizards Beyond Waverly Place)

Michael Bishop - Max (Spin)

Mekonnen Knife - Vargas (Z-O-M-B-I-E-S 4: Dawn of the Vampires)

Malia Baker - Chloe Charming (Descendants: The Rise of Red)

Mars - Teenage Maleficent (Descendants: The Rise of Red)

Mickeey Nguyen - Tracey (Z-O-M-B-I-E-S)

McKenna Grace - Jasmine Bernstein (Crash & Bernstein), Jules (Dog with a Blog), Quinn (K.C. Undercover), Didi (Bizaardvark), Bella (Elena of Avalor)

Morgan Dudley - Ella (Descendants: The Rise of Red)

N[]

Nancy Cartwright - Rufus / Various voices (Kim Possible), (The Replacements)

Nick Spano - Donnie Stevens (Even Stevens)

Nick Jonas - Nick Lucas (J.O.N.A.S.), Nate (Camp Rock)

Nicole Anderson - Macy Misa (J.O.N.A.S.), Marissa Hughes (Hannah Montana)

Nathan Kress - Jamie (The Suite Life of Zack and Cody) Brady Rider (Absolutley Alessandra), Freddie Benson (iCarly)

Nicholas Braun - Zeke (Minutemen), Ed (Princess Protection Program)

Nate Hartley - Carl (J.O.N.A.S.), Aaron (Hannah Montana), Ozzie (Zeke & Luther), Jeb (iCarly), Mitch the Snitch (Unfabulous)

Nancy McKeon - Connie Munroe (Sonny With A Chance)

Navia Robinson - Nia Baxter (Raven's Home)

Nathan Lovejoy - Principal Swift (Gabby Duran & the Unsittables)

Nathan Arenas - Jorge (Bunk'd)

Nina Lu - Tiffany Chen (Bunk'd)

Nicolas Bechtel - Lewie Diaz (Stuck in the Middle)

Noah Cottrell - Ivan (Saturdays)

Nikki Hahn - Lindsay (Jessie), Emily Cooper (Adventures in Babysitting)

Noah Centineo - Dallas (Austin & Ally), Monroe (Shake It Up), Rick Larkin (Jessie), Jaden Stark (How to Build a Better Boy)

Natalie Lander - Annie (Hannah Montana), Darci (K.C. Undercover), Whitney (Bizaardvark)

Nathaniel Potvin - Shane (Jessie), Academic Top Half (Girl Meets World), Ryan Walker (MECH-X4)

Noah Galvin - Jerbo (The Owl House)

Nik Dodani - Gavin (The Owl House), Thad (Hailey's On It!)

Noah Munck - Timmy O'Hallahan (Wizards of Waverly Place), Xavier (Phineas and Ferb)

Nicolas Cantu - Prince James (Sofia the First), Kid #1 (Walk the Prank), Travis (Raven's Home), Jackson (Bizaardvark), Dominic (Sydney to the Max), B.O.Y.D. (DuckTales), Teia (Puppy Dog Pals), Otto (Hailey's On It!)

Noah Zulfikar - Jacey (Z-O-M-B-I-E-S 2 & Z-O-M-B-I-E-S 3)

O[]

Olesya Rulin - Kelsi Neilsen (High School Musical, High School Musical 2, High School Musical 3: Senior Year) Natalie (Halloweentown High)

Orlando Brown - Eddie Thomas (That's So Raven), Fransisco "Frankie" (Eddie's Million Dollar Cook-Off), Sticky Webb (The Proud Family), Cornelius Fillmore (Fillmore!), Andy Baxley (Phil of the Future), Dobbs (Max Keeble's Big Move), Travis Elliot (Lizzie McGuire)

Olivia Holt - Kim (Kickin' It), Skylar Lewis (Girl vs. Monster), Lindy Watson (I Didn't Do It)

Olivia Rodrigo - Paige Olvera (Bizaardvark), Nini-Salazar Roberts (High School Musical: The Musical: The Series)

Olivia Sanabia - Charlotte Wrather (Coop & Cami Ask the World)

Omar Gooding - Cal Johnson (Saturdays)

P[]

Phill Lewis - Principal (Lizzie McGuire), Mr. Moseby (The Suite Life of Zack and Cody & The Suite Life On Deck), Maurice (Dadnapped)

Peter Vives - Angel (The Cheetah Girls 2)

Patrick Warburton - Kronk (The Emperor's New Groove), (Kronk's New Groove), (The Emperors New School)

Patrick Bristow - Patrick (The Suite Life of Zack and Cody) Evil Genius Stupid Helper (Underdog)

Paul/Peter Vogt - Mr. Dontzig (Hannah Montana)

Phil Baron - Eeyore and Piglet (Welcome to Pooh Corner)

Patricia Parris - Daisy Duck (Mickey's Christmas Carol), Lilly the Cat (Dumbo's Circus), Christopher Robin's Mother and Kanga (The New Adventures of Winnie the Pooh), Daisy Duck (Mickey's Magical Christmas: Snowed in at the House of Mouse)

Patrik Levis - Jack Phillips (So Weird)

Paxton Booth - Ollie Wrather (Coop & Cami Ask the World)

Peyton Clark - Garrett Spenger (I Didn't Do It)

Peyton Elizabeth Lee - Andrea "Andi" Mack (Andi Mack), Sam (Secret Society of Second-Born Royals), Mandy Yang (Prom Pact)

Peyton List - Emma Ross (Jessie, Bunk'd), Ellie O'Brien (The Swap)

Piper Curda - Kennedy Van Buren (A.N.T. Farm), Jasmine Kang (I Didn't Do It), Alyssa (Teen Beach 2), Rose (Raven's Home)

Pearce Joza - Spyder (MECH-X4), Wyatt (Z-O-M-B-I-E-S 2 & Z-O-M-B-I-E-S 3)

Preston Oliver - Griffin Campbell (Secrets of Sulphur Springs)

Peyton Meyer - Lucas Friar (Girl Meets World)

Peyton Z. Basnight - Ari Stevens (Saturdays)

Priah Ferguson - Bailey Carter (Hamster & Gretel)

Peder Lindell - Morgie (Descendants: The Rise of Red)

Q[]

R[]

Raini Rodriguez - Annoying Arlene (I'm in the Band), Trish (Austin and Ally), Barb (Bunk'd)

Ricky Ullman - Phil Diffy (Phil of the Future), Eric (Kim Possible: So the Drama), Jake Haskell (That's So Raven), Roscoe (Pixel Perfect),

Raven Goodwin - Ivy Wentz (Good Luck Charlie)

Raven-Symone - Raven Baxter (That's So Raven, The Suite Life of Zack and Cody and Raven's Home), Delroy Baxter (That's So Raven and Raven's Home), Faye Baxter & Baby G (That's So Raven), Galleria Garibaldi (The Cheetah Girls), (The Cheetah Girls 2), Iridessa (Tinker Bell), Maria Media (Big City Greens)

Roshon Fegan - Sander Loya (Camp Rock), Ty Blue (Shake It Up)

Romi Dames - Traci Von Horn (Hannah Montana), Hiromi (Hamster & Gretel)

Rebecca Rosso - Jessica (The Suite Life of Zack and Cody)

Rebecca Creskoff - Sandy Lucas (JONAS)

Big Rob - The Big Man (JONAS)

Ross Lynch - Austin Moon (Austin and Ally), Brady (Teen Beach Movie), (Teen Beach Movie 2)

Rich Ceraulo - Santiago Geraldo (Sonny With A Chance)

Ron Gans - Kanga and Roo (Welcome to Pooh Corner)

Ronni Hawk - Rachel Diaz (Stuck in the Middle)

Rowan Blanchard - Riley Matthews (Girl Meets World), Cleo (Invisible Sister)

Ricky Garcia - Naldo (Best Friends Whenever)

Ruth Righi - Sydney Reynolds (Sydney to the Max)

Ruby Rose Turner - Cami Wrather (Coop & Cami Ask the World), Bridget (Descendants: The Rise of Red)

Ramon Reed - Owen (Just Roll With It)

Rondell Sheridan - Victor Baxter (That's So Raven, Cory in the House & Raven's Home)

Rebecca Metz - Jenna Wrather (Coop & Cami Ask the World)

Robert Carradine - Sam (Lizzie McGuire)

Raphael Alejandro - Matteo Silva (Bunk'd)

Reed Horstmann - Jake/Chaos (The Villains of Valley View)

Regan Burns - Bennett James (Dog with a Blog)

Ryan McCartan - Diggie Smalls (Liv and Maddie)

Raymond Ochoa - Augie (Good Luck Charlie), Zane (I Didn't Do It)

Rico Rodriguez - Rico (Cory in the House), Leo (Good Luck Charlie), Benny (Austin & Ally), Snow-Foot (Jake and the Never Land Pirates), Raha (The Lion Guard), Baxter (Bunk'd)

Ricardo Hurtado - Austin Justin (Bunk'd)

Ross Butler - Brett Willis (K.C. Undercover), Spencer Watkins (Teen Beach 2)

Reid Shapiro - Iggy (Sydney to the Max)

S[]

Sabrina Bryan - Dorinda Thomas (The Cheetah Girls), (The Cheetah Girls 2), (The Cheetah Girls: One World)

Sabrina Carpenter - Maya Hart (Girl Meets World), Jenny Parker (Adventures in Babysitting), Melissa Chase (Milo Murphy's Law)

Sadie Stanley - Kim Possible (Kim Possible (film))

Sarah Gilman - Delia Delfano (I Didn't Do It)

Scarlett Estevez - Gwen Flores (Bunk'd), Rowena (Christmas Again), Violet Rodriguez/Ultra Violet (Ultra Violet & Black Scorpion)

Sean Giambrone - Ron Stoppable (Kim Possible (film)), Reggie (The Ghost and Molly McGee)

Selena Gomez - Mikayla (Hannah Montana), Gwen (The Suite Life of Zack and Cody), Alex Russo (Wizards of Waverly Place), (Wizards of Waverly Place: The Movie), (Wizards Beyond Waverly Place), Carter Mason (Princess Protection Program), Herself (Sonny with a Chance)

Shanica Knowles - Amber Addison (Hannah Montana), Shauna (Jump In!)

Sierra McCormick- Olive Daphne Doyle (A.N.T. Farm), Creepy Connie (Jessie)

Sofia Wylie - Buffy Driscol (Andi Mack), Gina Porter (High School Musical: The Musical: The Series)

Sophia Hammons - Amy (Under Wraps (2021 film) & Under Wraps 2)

Sophie Tamiko Oda - Barbara Brownstein (The Suite Life of Zack and Cody)

Summer Hamilton - Summer Liya (Moved To America)

Sammi Hanratty - Holly O'Neil (The Suite Life of Zack and Cody), Taylor (That's So Raven), Kristin Wibbler (Shake It Up)

Steven R. McQueen - Derek (Minutemen)

Seth Ginsberg - Toejam (As The Bell Rings)

Shia LaBeouf - Louis Stevens (Even Stevens), (The Even Stevens Movie), Eddie Walker (Tru Confessions) Stanley Yelnats IV/"Caveman" (Holes)

Samantha Droke - Brooke (Princess Protection Program)

Scheana Marie Jancan - Maria (Jonas)

Siena Agudong - Brittany (Sydney to the Max), Reina Carvajal (Upside-Down Magic) , Mikka (Raven's Home)

Sky Katz - Tess (Raven's Home)

Stefanie Scott - Lexi Reed (A.N.T. Farm) and Katie Star (Star Family)

Sterling Knight - actor (Hi-Jinks), Lucas (Hannah Montana), Brad (Out Of Jimmy's Head), Chad Dylan Cooper (Sonny With A Chance & So Random!), Christopher Wilde (Starstruck), Chad Dylan Cooper (So Random!)

Steve Hytner - Murphy (Sonny With A Chance)

Sofia Carson - Chelsea (Austin & Ally), Evie (Descendants, Descendants 2, Descendants 3), Lola Perez (Adventures in Babysitting), Herself (Walk the Prank)

Skai Jackson - Zuri Ross (Jessie and Bunk'd)

Suzi Barrett - Rachel (Just Roll With It)

Shiloh Verrico - Winnie Weber (Bunk'd)

Sofia Rosinsky - Zora Morris (Fast Layne)

Sophie Pollono - Layne Reed (Fast Layne)

Shelby Simmons - Natalie (Andi Mack), Ava King (Bunk'd)

Spencer Boldman - Adam Davenport and Adam Henderson (Lab Rats), Ted (Jessie), Jackson (Zapped)

Sydney Park - Sydney (That's So Raven), Kelsey DiAria (Hannah Montana)

Spencer Locke - Candida Keegel (Phil of the Future), Kayla (That's So Raven)

Steven Anthony Lawrence - Beans (Even Stevens and The Even Stevens Movie)

Sophie Reynolds - Ashley (Gamer's Guide to Pretty Much Everything), Juniper (Big Hero 6: The Series)

Siobhan Murphy - Grim Reaper (Pretty Freekin Scary)

Sarah-Nicole Robles - Luz Noceda (The Owl House)

Scarlett Pomers - Suzy Austin (A Ring of Endless Light)

Spencer List - Eric (Bunk'd)

Skyler Samuels - Gigi Hollingsworth (Wizards of Waverly Place)

Swayam Bhatia - Karishma (Mira, Royal Detective), Sofi Hanson Bhatt (The Mighty Ducks: Game Changers), Kyra (Alice's Wonderland Bakery), Vera (Z-O-M-B-I-E-S 4: Dawn of the Vampires)

Sam Morelos - Meadow (Descendants: The Rise of Red)

T[]

Tahj Mowry - TJ (Smart Guy), Wade (Kim Possible), Brandon (The Suite Life of Zack and Cody)

Tamera Mowry - Camryn Barnes (Twitches)

Tara Lynne Barr - Haley (The Suite Life of Zack and Cody)

Tenzing Norgay Trainor - Parker Rooney (Liv and Maddie)

Thomas Sangster - Ferb Fletcher (Phineas and Ferb)

Tia Mowry - Alex Fielding (Twitches)

Tiffany Thornton- Tawny Hart (Sonny With a Chance & So Random!), Jamie (Hatching Pete), Tyler Sparks (That's So Raven), Becky (Hannah Montana), Susan (Hannah Montana)

Tobie Windham - Byron (Just Roll With It)

Tony Oller - Danny (As The Bell Rings)

Tom Skerritt - Corky Mardis (Disney's Wonderful World), Bill Grand (The Parent Trap 2), Don Bared (Danger Bay)

Trevor Tordjman - Bucky (Z-O-M-B-I-E-S series), Himself (Disney Fam Jam), Parker Preston (Bunk'd)

Tyler James Williams - Cyrus DeBarge (Let It Shine)

T'Keyah Crystal Keymah - Tanya Baxter (That's So Raven & Raven's Home)

Trinitee Stokes - Judy Cooper (K.C. Undercover)

Tammy Townsend - Kira Cooper (K.C. Undercover)

Tom Virtue - Movie Dad (Under Wraps), Announcer (Miracle in Lane 2), Investment Banker (Horse Sense), Science Teacher (Brink!), Steve Stevens (Even Stevens, The Even Stevens Movie), Dr. Horn (That's So Raven), Ralph Bartlett (Read It and Weep), Coach Zappalla (Coop & Cami Ask the World)

Tim Johnson Jr. - Derek "D-Rok" Troy (Saturdays)

Terry Hu - A-Spen (Z-O-M-B-I-E-S 3)

Trevor Jackson - Kris McDuffy (Let It Shine), Trent (Austin & Ally), Lincoln Treadwell (K.C. Undercover)

Tati Gabrielle - Wackie Jackie (K.C. Undercover), Willow Park (The Owl House)

Tyrel Jackson Williams - Jasper (Good Luck Charlie), Hilo Tutuki (Pair of Kings), Leo Dooley (Lab Rats)

Tania Gunadi - Allison Wong (Even Stevens), Cindy (Pixel Perfect), Mojo (Go Figure), Emma Lau/Dark Tamara (Aaron Stone), Harper Burgess (Girl Meets World), Miss Elodie (Sofia the First), Tala Ordonia (Star vs. the Forces of Evil), Miss Kimberly (Fancy Nancy), Natalie (Bizaardvark), Lumba-Lumba (The Lion Guard), Pliny (StuGo)

Tristan Michael Brown - Lyle (Bunk'd), Carson (Pretty Freekin Scary)

Tiffany Espensen - Samantha (Hannah Montana), Ginger Hirano (Phineas and Ferb), Kelly (Good Luck Charlie), Belinda (Kirby Buckets), Rama / Heng Heng (The Lion Guard)

Tucker Albrizzi - Gordo (Lab Rats), Jake (Good Luck Charlie)

Taylor Cora - Winter (Wizards Beyond Waverly Place)

U[]

Uriah Shelton - Prince Jeffy (The Suite Life On Deck), Joshua Matthews (Girl Meets World)

Utkarsh Ambudkar - Anand (Marvel's Moon Girl and Devil Dinosaur)

V[]

Vanessa Hudgens - Gabriella Montez (High School Musical), (High School Musical 2), (High School Musical 3: Senior Year) Tintin (Thunderbirds), Corrie (The Suite Life of Zack and Cody)

Veronica Dunne - Marisa (K.C. Undercover)

Victoria Justice - Rebecca (The Suite Life of Zack and Cody)

Vincent Martella - Phineas (Phineas and Ferb & Milo Murphy's Law), Bradley (Milo Murphy's Law)

Vicki Lewis - Mrs.Bitterman (Sonny With A Chance), Dina Reams (Den Brother), Headmaster Knightslinger (Upside-Down Magic)

Valery Ortiz - Dina (Gabby Duran & the Unsittables)

W[]

Wendy Worthington - Brenda (Sonny With A Chance)

Will Buie Jr. - Finn Sawyer (Bunk'd)

Will Ryan - Harold The Seahorse (The Little Mermaid), Tigger and Rabbit (Welcome to Pooh Corner)

Winslow Fegley - Mel (Fast Layne), Andy (The Naughty Nine)

Y[]

Yasmeen Fletcher - Kaitlin (Andi Mack), Chandra (Upside-Down Magic)

Yolanda "Yo-Yo" Whitaker - Duchess (Saturdays)

Yonas Kibreab - Ernie (Raven's Home), Remy (Pretty Freekin Scary)

Yuvi Hecht - Erlic (Pretty Freekin Scary)

Yara Shahidi - Olive (Wizards of Waverly Place)

Z[]

Zac Efron - Troy Bolton(High School Musical, High School Musical 2, High School Musical 3: Senior Year), Trevor (The Suite Life of Zack and Cody) , Davey Hunkerhoff (The Replacements)

Zelia Ankrum - Maya Miller-Martinez (Ultra Violet & Black Scorpion)

Zendaya - Rocky Blue (Shake It Up), Halley Brandon (Frenemies), Sequoia (A.N.T. Farm), Zoey Stevens (Zapped), K.C. Cooper (K.C. Undercover)

Zeno Robinson - Remy Remington (Big City Greens), Hunter (The Owl House)

Zach Callison - Douglas (Hannah Montana), Prince James (Sofia the First: Once Upon a Princess & Sofia the First)

Zach Reino - Zillon (Big City Greens), Chip (StuGo)

Zosia Mamet - Hekapoo (Star vs. the Forces of Evil), Merian (StuGo)

Zayne Emory - Howard (Shake It Up), Graham (A.N.T. Farm), Tad Monaco (Kickin' It)

See also[]